5 5
0
b f b e R 
e y r e e 
G r G s e 
e e r e e 
g e m e e 
