5 5
0
m r R e c 
s R B e e 
r c b e g 
m v e c f 
B r e R r 
