5 5
0
g e B e e 
e w y e y 
R e g g G 
r B r e G 
f r e s b 
