5 5
0
e b R g e 
e m G e e 
e s c e e 
e c e c e 
B e r f c 
