5 5
0
e s e g f 
R e r e m 
e r G e e 
c e e m e 
e e B g e 
