5 5
0
e G G w c 
r R g e e 
s b w m e 
B y e e f 
w G e e e 
