5 5
0
f w R e e 
r m e e s 
r G w e e 
e y w e e 
e G r b B 
