5 5
0
r f y e e 
e c g G s 
v g e b w 
r m e R c 
G R B e y 
