5 5
0
e e g e f 
b e b r e 
v r r e y 
e e e B s 
R r e G e 
