5 5
0
s B r e e 
h e e m f 
e m e c r 
b G y e e 
e e e e R 
