5 5
0
e R s c m 
B y b R G 
y B e y y 
y w w b g 
f B c e e 
