5 5
0
e b e s R 
f w r m w 
y e R e e 
e e c e e 
e e B e b 
