5 5
0
f m s G e 
e m R e e 
R w r e e 
c c e y w 
e w e e B 
