5 5
0
B R G s e 
e e r h e 
e e y c y 
e m b e G 
w r f b e 
