5 5
0
R h r f e 
e c G r w 
R r e e m 
e e w e e 
g e m B s 
