5 5
0
B b e e G 
c b e m R 
e f c s e 
e e e w e 
e r e y e 
