5 5
0
g e b e s 
f e e c e 
h e y w R 
e y G y R 
e b e e e 
