5 5
0
R e G b r 
s e e y e 
e b w e c 
b e G B e 
f b b e h 
