5 5
0
B e f b m 
m e y y m 
e b r e R 
s e e g B 
R m e c G 
