5 5
0
b e g e m 
s g f g e 
R e g e m 
e B e e G 
e e e v e 
