5 5
0
v e g e b 
e G e e s 
b y e b g 
e e m G e 
f y e e B 
