5 5
0
f w e R e 
w g e e G 
b s y c b 
e e e e e 
b e e e B 
