5 5
0
B R w e e 
e e y f c 
R e e y b 
e s e c b 
b y b G B 
