5 5
0
r R e w h 
e e c b f 
s e G y g 
c e e e m 
B e e e e 
