5 5
0
h c e e e 
B e w e R 
e s G r r 
y b e e e 
f w c e e 
