5 5
0
y f r e e 
B g r B e 
e s b y r 
e v b e e 
e e g R B 
