5 5
0
g b R e h 
B y e e e 
w e y e b 
w G s e b 
R w e m f 
