5 5
0
e e e B m 
G e e c R 
e s B g e 
e w w e e 
y f c w e 
