5 5
0
R y b f e 
s G r b b 
b m R r e 
e e B v e 
w e e e m 
