5 5
0
G w e e e 
y f w e v 
w c e e G 
w s r e e 
R e e g B 
