5 5
0
e e e e e 
b e B b e 
s r R e v 
e e m b e 
e B m b f 
