5 5
0
r e m e G 
w b G c B 
f y e g B 
b y y s R 
y c e e b 
