5 5
0
y e e e e 
G B e g w 
r b b y f 
G g s r c 
R r e e G 
