5 5
0
c G m c f 
e b R y e 
e v g c r 
e e w e e 
s B c R r 
