5 5
0
m f b B m 
s w e r e 
e e b R e 
y e e G e 
e e e e e 
