5 5
0
g e R B e 
e w e c B 
f b y s e 
m e m e e 
e e b c B 
