5 5
0
r e y f b 
e G e m e 
e h G r R 
R w e s g 
e y r e e 
