5 5
0
e b y f e 
v B b y e 
s B b e g 
R w y R e 
g G e e e 
