5 5
0
B e G e e 
R m s w w 
b c w c f 
m e e e e 
e m e e e 
