5 5
0
e m f r e 
e e r e y 
e g e e e 
e s y G e 
c G b e R 
