5 5
0
f m m e g 
y e c r B 
w R s g R 
e e r e e 
e e e b e 
