5 5
0
R e m c e 
r c e B s 
e R b e m 
e r w c f 
G c e e r 
