5 5
0
f e m e e 
w r b e e 
e w e w G 
e r e e s 
b B R e e 
