5 5
0
e g e f w 
m e b b G 
e e b w m 
w w r e s 
B G R e e 
