5 5
0
r e e e G 
B s e e e 
g c w e g 
f R e c G 
e e c e y 
