5 5
0
e f m b e 
r w e v b 
w B r e e 
e R e e e 
e R m s g 
