5 5
0
g f y R w 
e b e g m 
s e e e R 
r e e b e 
B w h e G 
