5 5
0
G s g e r 
c y e e e 
e f m v e 
e w g B e 
e R b R e 
