5 5
0
r e c e s 
f w R e y 
r G r r e 
e m e R e 
y e e B e 
