5 5
0
b e e r e 
m R b s G 
f w c G R 
e y b r b 
g m b B R 
