5 5
0
e e w e e 
c f b e e 
e m G y e 
G r s r e 
h R g B e 
