5 5
0
R m e m G 
e b f w G 
B g r s e 
h g e m e 
G b e g e 
