5 5
0
e e e e g 
R G w g e 
e y G B c 
b e w s e 
f c G c e 
