5 5
0
r w e y r 
R e e r e 
e s h r e 
b y w e G 
e f e m B 
