5 5
0
e e m b c 
e s h e B 
c r e R e 
e y r G b 
f m G b e 
