5 5
0
c e e G r 
e B y c e 
R e e b m 
y s w c G 
e y e e f 
