5 5
0
c R B e y 
e e m b e 
s g e e B 
w e e e e 
f r e b e 
