5 5
0
f m e B h 
b e e e b 
m G b w e 
g e r s G 
e m b R e 
