5 5
0
e b r e e 
f b r e G 
r e G w y 
e s y R e 
r e g e e 
