6 6
0
e s e w h c 
G B b w w y 
c w m r R e 
e e c y c g 
e c e b f m 
R g e w R G 
