6 6
0
h e m e f g 
R e c r y h 
r v w r w B 
b e R G w R 
y m e m b e 
G w m R s r 
