6 6
0
w b e r G e 
e f w B m R 
r e b c y B 
g b r m s B 
w G c e R w 
e w y r R e 
