6 6
0
e R m e m y 
G c e G w e 
r r e s w m 
e e r e y e 
y G e g y y 
B R c w f g 
