6 6
0
e e e e e R 
e e s y b b 
g b e m c b 
e R r B c m 
e y b y f B 
G c G R h c 
