6 6
0
R y f m v v 
e b r e y G 
g e R r e e 
e e e m s e 
g g e w B B 
e e e g g h 
