6 6
0
v e B e G e 
m e c h b v 
B y y b c m 
R b e r f r 
e s m r y e 
m g G R m e 
