6 6
0
e r e R G r 
e e h c r s 
c y e e e e 
y e b e e e 
B R y R e c 
g e r h w f 
