6 6
0
G g e e b e 
B y b B e e 
e s y e e e 
e c e e R e 
w r c e b c 
e f r w e G 
