6 6
0
G e e r e f 
G e r e y y 
b e e b G w 
R r y b B e 
e c e s e e 
e e w w e b 
