6 6
0
e B e e s R 
r y e e g e 
R v g b e e 
b G b g w e 
B b b f c e 
b e e r R b 
