6 6
0
e e b r m f 
m v e b e m 
e h R c e y 
e e b e R s 
R e g e w G 
B w e e c e 
