6 6
0
e e r g R h 
b G b e G B 
r e y e e y 
e s e r y w 
e g B m e B 
e e r f m e 
