6 6
0
y B m f m w 
G e b w G c 
r g e m g e 
B b R e B e 
e e c e c s 
r R y g e y 
