6 6
0
v w e g e G 
G b h g e B 
f w R s m y 
e m e G b h 
e w c y R e 
e e w e m w 
