6 6
0
m s e e h c 
e v v e c f 
e G e r e c 
y e g b G e 
c y B R r e 
G e e r e r 
