6 6
0
r m e c f e 
r y w e w b 
e c m b c h 
R y m G e e 
e s e c G e 
e B r w B R 
