6 6
0
e g e y e e 
b B R g e e 
B r c e b G 
f b m e e e 
b R c e e h 
G c e s c v 
