6 6
0
e G w e s e 
g e m e y G 
e e e g e m 
w R R r y e 
e e e c c m 
B e b g f e 
