6 6
0
s w e h e B 
R e r R G e 
e y e e m e 
e b G G c e 
e c m c e c 
c f y e e e 
