6 6
0
e w B e g R 
e e s g e e 
w e e b B e 
e b w e r w 
b r g r R e 
w f g R G e 
