6 6
0
y m w R b e 
r e h c R h 
B B e m e e 
c e m f r g 
e s g c m h 
e e G w e R 
