6 6
0
g r e e e e 
e b c e G e 
r e e B y g 
e e e g G s 
c w B r w e 
e R r f w e 
