6 6
0
e c f c m R 
e e w e y e 
e e e b e e 
b v g h r G 
B e R s c w 
g r e h e R 
