6 6
0
e c v e r v 
w y G e B c 
R w e e w R 
e f r e b m 
v c b g e s 
e c g e B R 
