6 6
0
R m e r s R 
G e G m w y 
w m e c e R 
v R g e c g 
g v m e g v 
f m b e e B 
