6 6
0
s B e e r e 
r g e R g g 
e e w c e w 
R e e m e f 
e R m r w g 
e B g G e w 
