6 6
0
f b c e y b 
B g e y B G 
w m R e e g 
b g e e c e 
h e b b c r 
R e s e B w 
