6 6
0
g r G s e e 
e e b e e e 
e e b e e r 
e y G h g r 
f e y b G B 
e m e g B y 
