6 6
0
e h B G e g 
e e e g c s 
e e m G e R 
e w b r r w 
y f e g B e 
r w b v G e 
