6 6
0
B c h b e B 
r w s R b B 
f B c B r e 
g r c y g e 
w v r G c e 
w h r B m G 
