6 6
0
e e e w m e 
e f m e w e 
y y e e y w 
y e s b e B 
e e r e e R 
B e r G e R 
