6 6
0
f e y w B G 
e c h w e R 
g B e e r r 
e e e e h c 
R e e s b g 
y w e e b r 
