6 6
0
w h m w e R 
B e e c e h 
w e B y G v 
y y s e c e 
f y G e r B 
r g e e w m 
