6 6
0
e c f b r e 
B c y w e e 
G g e m e r 
e m r b R s 
g e G e c B 
G e e e e g 
