6 6
0
e v s e e w 
e b e B g e 
e R y e w e 
e m B g R c 
e w G G y c 
b R w w b f 
