6 6
0
m R e e e e 
w e m g B e 
B g G w e R 
f g y e e r 
g w e R s y 
e e e e c g 
