6 6
0
g R e e e e 
e m b m w m 
m w e s g B 
g R y G v e 
G c r G e e 
f h w g c e 
