6 6
0
y r e y e c 
G m y e f v 
e y e y e g 
e s c G w e 
B g h r G w 
r m h g e R 
