6 6
0
e w r g B w 
G R b m e f 
s c G g b m 
r w c B e c 
r e G e e e 
e g c e R e 
