6 6
0
r c R c e y 
R G c c b R 
f m B y w w 
y c g e b e 
G w b s B g 
B e B g r e 
