6 6
0
e R m w e e 
B e e w e e 
e v b w b f 
e y s R e w 
r e e e h e 
G r c r R g 
