6 6
0
e e e e R G 
r e h g r r 
B g g r y y 
R e g f e R 
B s m c B r 
e e e w c e 
