6 6
0
c w e e e b 
h b f e m G 
e B b w e R 
G e r g s m 
e w e e m e 
G e e h e v 
