6 6
0
R B e e e e 
e e e s e r 
b g b r g w 
c G G y f e 
e h e y e g 
e e B e y e 
