6 6
0
G e f b y e 
r B r m s e 
b g B c e e 
b m w e g B 
e e e e m e 
g e G w R e 
