6 6
0
G h e v e m 
c b e G B b 
e g c r m e 
c f b s e c 
g y e e y R 
g w R e v b 
