6 6
0
c B e h w e 
m e s e y e 
R e c b y e 
h c G v e G 
g G y B R c 
f m c e e c 
