6 6
0
h y f R v c 
g r e m G w 
G b g y c e 
e g r m e y 
B e R s e e 
R h e b e b 
