6 6
0
e e f e e y 
e w w r y e 
G e g R G b 
b w m w b e 
b w y s e B 
e B e c e w 
