6 6
0
e m e g e b 
G e g e G e 
s g g e e e 
e g B m m B 
y g e R e w 
f b e e e e 
