6 6
0
R e w G R c 
e R g h y f 
e v g g g r 
B B e w e r 
r e e w e c 
e s m G c e 
