6 6
0
R e R c e b 
r e e y e e 
m e e e G s 
y m e r e e 
G e c B m e 
f y e e w e 
