6 6
0
m G y b c e 
e e e c c f 
e e e R w h 
e m s b e w 
r v r e g R 
b B y B B r 
