6 6
0
r s e e G y 
e e m B w g 
y b R r G e 
g w y m g R 
B e f y G r 
b g w g y e 
