6 6
0
B G w v e f 
e y e e y e 
e w r m y c 
e c R G e b 
s c w y b e 
b e e e e B 
