6 6
0
m y e e e f 
e B w w h e 
e e e h m e 
G e e b r m 
b s r G B r 
e e c e R e 
