6 6
0
G g R e g r 
e e e w G y 
s y e c y e 
w B c b b e 
g c G G e e 
e g b f e B 
