6 6
0
r m B e m r 
e e e e B G 
y m m B e s 
m f w e e h 
e m g e e g 
e R B w e e 
