6 6
0
e R e b e r 
B w s m B g 
y e b r B m 
b R w v w G 
B m e e m g 
g e R e c f 
