6 6
0
e r R g e e 
c e B y f e 
B e w r g e 
s r e e w g 
c y R h e e 
e G e e e m 
