7 7
0
c m B r R s r 
f c e b g G e 
b e G e w e g 
g r r g y e g 
B R h e b e c 
m G R b e e e 
B g m e m e e 
