7 7
0
e G e g e e e 
R e e g h e e 
e e w g e e e 
B e m e c f w 
g w e e c e e 
B G r r y c g 
R e e R s r e 
