7 7
0
e w e w G g e 
f w h e g B b 
b e s w e e e 
y e G e b e e 
c b b r w G e 
e G e r m g e 
e e e G G w y 
