7 7
0
e g e e w f e 
c G c g b B e 
e e s e r w w 
g B r e R b G 
R g e e m y e 
e y y m e e w 
e e e e g G y 
