7 7
0
b b s g g e B 
g e e w c R m 
c G g h m e e 
e e G G e r w 
e b c b R e b 
e m e e b b G 
e r y b B f e 
