7 7
0
e e v w e f e 
e e s b c b e 
e G B e y e w 
m e m r B y e 
e g e e r e G 
R c e R g g R 
c w e e e g e 
