7 7
0
e e e e e e g 
y w e m w R e 
e r y r B g g 
e R v B y e e 
g R m y s e w 
w c f w e e e 
R R R r g e G 
