7 7
0
e g c w e r f 
s g e e R e G 
e e m e e B e 
e B c e e e e 
g e e m b m y 
e e e e w G c 
r g e G e g G 
