7 7
0
e e e R e B e 
e e R e m c s 
e e e g e G y 
r e w r e e b 
R e g e r e c 
G c B e r r e 
w e e e h e f 
