7 7
0
w b s B R g y 
e b m w G g y 
G r R e g g m 
R e c e G b w 
g g b m c y w 
g y m R r R r 
e R e y f G e 
