7 7
0
B e e r e e e 
e e e R r g e 
g e e b e e r 
g e G b B y f 
G m G m e b m 
e e e b b e B 
e y e y b e s 
