7 7
0
G e R y g e m 
y s m e r c f 
e r e w r e b 
R g g m r e e 
w e e c e e e 
R e e e w r B 
c G v y y e B 
