7 7
0
f w e b e y e 
r y y m e B e 
r c e e b G e 
R e g c e s w 
r G e h m g R 
e e y r e B w 
R e w B R R b 
