7 7
0
e c G r B w e 
r g e c e c f 
e e y e B e c 
G e b e h e e 
g w e y e R e 
y R r e e e e 
r e b R s e e 
