7 7
0
e r c e e s e 
G f b R g b w 
e e w r e e e 
e g e e e e e 
y R y e e R B 
R B g e c r g 
e e m e g c e 
