7 7
0
m B e m f e e 
e b e e g r r 
g e b e e m e 
r B g s b b B 
w R e b e B b 
e y e c v B c 
e e e G g e b 
