7 7
0
R y m G e G e 
f c r e y e e 
w e B r g y r 
y e R b G e h 
e g c c y e e 
w B e R s b e 
e b R w e w e 
