7 7
0
e b e r g B R 
e e y e e y s 
e r R w R e e 
w e g G b y m 
f y y R e B w 
e r G r e e e 
e e b w e m e 
