7 7
0
m c e m G m f 
c w b w e G m 
e e e v g G e 
y e G s w g e 
e e e c G r y 
e e e R r B e 
e e e e e e e 
