7 7
0
e e r e e e e 
g R f e e v e 
m w r y r R e 
e e g e g e e 
e b R g e b c 
e m B w B b R 
e e r e y s G 
