7 7
0
G e w e e c e 
e e e e e w R 
R s e r e w f 
c g e c m b G 
m m y e g e e 
m G e c r e e 
e e y R e g B 
