7 7
0
e e G e e R b 
m R r e e g e 
g m G g c e R 
e w R s y e b 
f c y g B e m 
c e w G R b e 
e c y w e e e 
