7 7
0
e y e G b b R 
e r r e r e B 
c e v w c b G 
e e e w m m e 
e e B G e s c 
e y e y e e G 
e b y f y c g 
