7 7
0
e G c g w f r 
R w B y e w e 
e e g e e G e 
R B y b e b e 
r e c e e g r 
B b e c e b y 
e s e B b e y 
