7 7
0
e e G w r R w 
e f e r g e e 
w y r g y e e 
G R b w G G m 
e h e e w e e 
e b w g m b g 
e c B s R e g 
