7 7
0
g e r e e b c 
B e e e g w f 
m e e c e c G 
r R g e s y e 
R g b R g m c 
G e e r e B h 
m b e y e e e 
