7 7
0
e g e b R w e 
f y g m R e e 
h y y e m e c 
e e e r y B e 
c e c m e s G 
r R g B b b g 
G e R r e e r 
