7 7
0
c e s e c b e 
B G B m b R w 
R r y r b e e 
r G w B g e e 
w B b e e e e 
g m e w r G e 
c m g w e e f 
