7 7
0
G r e b e e R 
R e h b e e g 
g e r R e b e 
B m e s e c g 
e w e R y e f 
R m b e w e e 
c e w r e g r 
