7 7
0
G b e m e f r 
w c e e e e w 
e w e e r B y 
e c m g R r w 
B m r b e e e 
b G m w e w e 
B e R s c e B 
