7 7
0
b g e e R e R 
g g e c r w y 
v e b G e w e 
w y c e y G r 
G f m b b m B 
R g r e b s e 
e e e r r B B 
