7 7
0
b f g g w R B 
e e g e m e r 
c e B e m y G 
w e r c y g G 
e e e c m e G 
w m r e e w s 
e e e e e g R 
