7 7
0
e e c w e e B 
g e G w e e m 
f e g g g e r 
e g e c s e B 
c e b w R r e 
h b G e b r m 
G c r e c B e 
