7 7
0
R R e b r w w 
B e m e g e e 
e e e m B g e 
G e m e e e r 
y y B w s R e 
e r e e r y e 
w e y v g f g 
