7 7
0
e B r e e e e 
c c e r e c e 
B e e w g B e 
r e s e y e e 
e r w e r R e 
g r e b b e G 
B f y e e B e 
