7 7
0
G e R c R y e 
e e w G b w r 
e B w g f e e 
m v e m g w b 
y e e e r s G 
m e e e w w R 
e y w e e b e 
