7 7
0
h G e g e b B 
B b y e r e e 
c B e e c e e 
f g m e e b e 
r b y w w s e 
m e e m e e e 
G e e G w R e 
