7 7
0
e e e c e e G 
e e e e e e e 
c e e e G e r 
f g y r g e c 
y B c r R g e 
R e s y r r g 
e e m e B G b 
