7 7
0
R b R e e B e 
s m g e R e G 
B g g e g e r 
w c e g g e e 
G e e c m e e 
c e w h e e e 
f w e y e e y 
