7 7
0
r e r e e w b 
r e y r w e f 
B e e m e g c 
G e g e b B m 
e b e e B c B 
r R B r c s e 
m e e e e e y 
