7 7
0
y e m e e e g 
e m G y e b e 
f e b e w G m 
c b w R e y e 
e w R b s e g 
m B e y G g e 
e B m r c e e 
