7 7
0
y g e R g B e 
G B g w e m y 
b w g r f m c 
e m m b g r e 
h G e G c s g 
b e e r B e e 
G e g m G R e 
