7 7
0
R e e g e b m 
B m b e g R e 
e m s w c c B 
e w B e c b b 
e r e b B g e 
e w w b e m f 
e e e e r R m 
