7 7
0
c R G e b G G 
y R b b e G w 
R r y r c e y 
B s c y e b w 
R e c r G B c 
e g m m R g r 
r B c f w m e 
