7 7
0
m e B e r e w 
R g e e b G G 
e s b e B b R 
B c e m e e e 
w G y e b b b 
r e r c y b g 
r v b f w e B 
