7 7
0
b e c v e e e 
e G g R G m B 
e e c B r s g 
m w c g e e e 
e R g y g b e 
G B b G e e e 
m e f r w g g 
