7 7
0
e R G g e e w 
m r b e r e e 
B e m e e R s 
e m r m e e G 
b G e e c r g 
r e w c e g B 
G g y f w e m 
