7 7
0
y e e e e y B 
y e e e e s e 
e c G w e c c 
R e r e r e G 
y B g e e m e 
B w m m B g h 
e b e f w r b 
