7 7
0
e w e e R R r 
e e e e w e m 
y b g w b e b 
s e m e e b R 
e w m w e f B 
G m e G y b e 
e e B g h r e 
