7 7
0
e e m e e e e 
e B e e m e r 
y G g w R e y 
f y e e e m B 
e w e e e R m 
e e c y g s g 
G b e e m e R 
