7 7
0
r g e e b e G 
e e b g e m r 
e e e G y e e 
w w R y R e e 
B e b c r f r 
G r s B g r B 
e v b r e G e 
