7 7
0
g g e e b e R 
e e w B e e e 
e g s e b e h 
e m g e g B r 
e e e r e g e 
w G r B R e G 
f b e e e b e 
