7 7
0
e f r e w G e 
g r y g s e e 
B c y c e r G 
e R g R m R e 
c e c r e v e 
y e e e w y b 
y e G g b r B 
