7 7
0
e e w B y r e 
r f b r e e e 
w m R w e c e 
r g g e e e G 
B h r e y c G 
e w B e e e y 
G b s m R g c 
