7 7
0
e y e R e r c 
m e r f e b R 
B r g e b r e 
m R w m m g g 
G e c e e e B 
B y s e e y G 
e r e e y e m 
