7 7
0
e e e e e G e 
g R w w e s m 
B w y y m G e 
g e e y G y w 
w e e g m y e 
y c f y R y B 
e G e e y m e 
