7 7
0
e r e G s e R 
e b e e e e e 
r g R g e c e 
r y b e e g R 
r B y r e e c 
b G y R c c e 
e R e e w e f 
