7 7
0
e r m G r g e 
g e r y b w e 
e G g e e r f 
e e c B G e r 
w B s y r c e 
e b y e y e e 
B e e e w R e 
