7 7
0
G R e r e e e 
g g e e b e e 
R w b e b s e 
R e g e g g B 
r e b g e e B 
e e e e c R e 
y f e y r e m 
