7 7
0
e B e e e y e 
g e G w g e b 
g R e r e B e 
r m m c e m b 
e w e e c G r 
b e R b c f e 
B e e s e g e 
