7 7
0
e g R c e e f 
B s e c e e c 
e y b c b y G 
e y b e y w e 
r R e b G g e 
G b h R e e m 
e c e e c c r 
