7 7
0
g s e e R b r 
R e m e c y e 
r y G e m e m 
g y e y b f w 
e e b R b B c 
G c e B c y G 
v e b e g B c 
