7 7
0
m m e g e r y 
e h e w c G r 
e e b B y R e 
e e e b e g e 
b f e g r B G 
e m g R s w y 
e e e e c R e 
