7 7
0
R e b e e e r 
f m y R e e e 
e b B y e e e 
e b w s c e w 
b e y e e m R 
e e m R m e e 
G y e e e e G 
