7 7
0
y e w e G e e 
f w R e e s g 
w m m b y m R 
e e y e e e B 
w G m r e e g 
e e g R r m e 
y B e r c m e 
