7 7
0
e R g R b e f 
s g h R c b e 
e y G R r e b 
e e m e e e c 
G e b e G w e 
g e m e e e e 
e e r B g e y 
