7 7
0
b e e G f b e 
e g G m e b R 
w b w r g g G 
s e r e r e w 
G e e B e r R 
e e b e w e e 
e e r e e R e 
