7 7
0
e e c e e e R 
B r e r e e w 
e m b f b g m 
m G b c G e y 
B b s e e y e 
v e y e R e e 
r w e e r e G 
