7 7
0
e c r e B e R 
w e e e e e g 
s e e m m e g 
e m B g e y e 
g R m b c e e 
c m e e c R f 
R e e G e c G 
