7 7
0
e m w R c e g 
e y e g g c f 
e B e R m g w 
B m e r w R G 
e R e e r e e 
b e e e g e R 
e e s w e y g 
