7 7
0
e e r b e B e 
e f r w e e m 
e w w e v r B 
b m e y m G e 
R y G e r e e 
G s m e e e g 
e c e b r c B 
