7 7
0
e g g r y c c 
w e m r G c G 
e f r m e e B 
m e w y G w G 
e e r m s e v 
c y B e b w e 
e g y b e e R 
