7 7
0
y e w w s R G 
e b B w e b v 
w e e R m B R 
e g c r r g g 
m r e b r b R 
m e B e m g c 
R e f g B c e 
