7 7
0
b b e e w f b 
e e r B y R e 
R G e c w b r 
e e e e c e R 
r e s e m e w 
e r e e b w B 
e r c e B g G 
