7 7
0
B b G e w B e 
h e e r e c e 
e c y e e w g 
c G s r m e e 
e e b b f B B 
e r c e m e r 
e R e m e b w 
