7 7
0
r B b e e g c 
g e e e y R e 
m e s R w e c 
R y b y w e e 
y e e e y G B 
R c G r e m f 
r c B c G b e 
