7 7
0
G e e e e r R 
e w c e c s B 
b f c m y e e 
e g e y c r g 
r e e e e B e 
c e e R e g B 
e G e e y e e 
