7 7
0
e e e y e g e 
e w y B b e e 
e y s g c e R 
e G G b G B e 
g e e w e g r 
c B e c w b e 
R y e r f e e 
