7 7
0
e e r e r e e 
e e e e e e e 
r e B B R G R 
e h e e G m e 
e w w m b g f 
G b g R e c w 
r G B m s G b 
