7 7
0
G e e G e R R 
e b w s e r c 
m B c e y e r 
w e e g g e m 
y w r G e m e 
e e B e m f e 
e e e e w m r 
