7 7
0
g s y R e g e 
w B G e B m G 
e y g G c B e 
e w r r e c y 
y e g R w e R 
e r e r G e e 
g G g f r e m 
