7 7
0
e e b e h B e 
r w f r w G B 
r m w y e c e 
c e e e b G e 
e e s c e e e 
c G e w y r e 
B g g R e e e 
