7 7
0
e e y G r B e 
r m y e B b G 
y e e m e b c 
e e e b e b b 
e e g b y h m 
g e e e B B s 
f c e R y e e 
