7 7
0
e e b e e e c 
R e e e e g R 
e e e e c B e 
y e B c e b g 
f y e y e e b 
c e s m b e G 
e e c G e R m 
