7 7
0
e m e b w e e 
e R m r B y e 
f e e e b e w 
R e c e b e e 
e e e b e e e 
R e e e b G G 
w r e g y s R 
