7 7
0
e e G g s e e 
w c f y R e e 
b B c e w g r 
e e e r B e e 
c r e g y e c 
e e e b b m R 
e G w g G e b 
