7 7
0
G w e e m f b 
e e y m y e c 
r w s e B g e 
e B e e b b b 
g r e g R e B 
G e c w e e r 
e e R e m b m 
