7 7
0
e y w c e R e 
e B m e e e r 
s e e g e e e 
e R y B w e G 
e e r R c r c 
e B e y v b w 
e e e g f e e 
