7 7
0
e e e c B r e 
e m c R g f y 
e m e e e w e 
B e c s e w G 
e y w w e b m 
e b R R r e e 
e e B e e e b 
