7 7
0
r e R w b e e 
B r w G r e c 
e c r e B s c 
w e b r m m G 
e c r e g b e 
y R e h w w R 
m e f G m w B 
