7 7
0
y e c m B b e 
e b G c G s m 
e e b b g m c 
y R y e w e e 
f g e e w e e 
g e e e e R e 
c e e B m B G 
