7 7
0
g s e B e w e 
e g e G b e b 
g y e w v b m 
G e y G e e r 
e e G g y m e 
e e e m w f w 
e e R e e w B 
