7 7
0
e e g e b e R 
e g e v e c e 
m w R s G e r 
g b c e e c e 
f y b c b e R 
m B r r e e g 
G w y B w e e 
