7 7
0
e b e e b r f 
y e e c G e r 
e e m y w y r 
B g e B G r e 
R r e e g e h 
e e w e s e B 
y g e r G e b 
