7 7
0
m e r e e g f 
g e e s c e w 
c R y R e B e 
r e e B e e m 
e e c e e v e 
b c e y w b r 
r R w R c e G 
