7 7
0
e y f b e w b 
e m y G c y r 
c w w e w g e 
G e r b B R G 
r R r e m g w 
m s r y w e e 
e y y G B B e 
