7 7
0
G r e w e c G 
R e e c e e g 
r e e w e e e 
r r B w g v f 
B b r e e y e 
s w e e B w m 
e R g e w g e 
