7 7
0
G r c w e R f 
e e e c b c R 
m e g e e r w 
e B w e e s r 
e r B b b e b 
e r e h r e e 
g R e R e y R 
