7 7
0
e e e b B e e 
e e e b G m B 
e w g G e e e 
y r e m e e e 
h R B b y s y 
G g g e c m e 
e c e r e f e 
