7 7
0
w b w e e e B 
B s e b e m e 
g m e m G e e 
e r e w e G r 
c G y w c e R 
f e e e w b e 
e e B e m b c 
