7 7
0
e y r e b G r 
R B e b e e e 
e f e y e e r 
e R r s r e r 
c w e B g e e 
r c B e c e e 
g e g B G g e 
