7 7
0
e e e f w B e 
g R g y e G e 
e m e r r s e 
e e e e r e e 
m e e G e c c 
r e R e g e e 
g e e c R R b 
