7 7
0
e r m e R r e 
c G e w r e b 
e e e G R c b 
m f R m e R g 
R c w w w r B 
s m b g e e e 
e e G y e e e 
