7 7
0
e r G e m y B 
e B G g e e R 
e y e g s g m 
c e y R b c e 
b f w g r e e 
e r e e e g e 
w e e e B e e 
