7 7
0
b c f m r e e 
r e e g m R r 
e y r e G b e 
g e e w y m b 
R e y e r s e 
e g e r m e e 
G B w B m v R 
