7 7
0
b G g w c e r 
f r G e e R B 
r e G e w c r 
c e e g e y B 
w B e g m G c 
g y c R B e e 
m e g e s e b 
