7 7
0
B g e R m f g 
e e r g y r e 
b w r b G m R 
e y B m v e g 
e s r r R c e 
G c b e b b m 
R e w e w B e 
