7 7
0
B m G w w c R 
e e c R m w y 
c G m w g e f 
e s r y e e e 
c w r e e y R 
e m e e e w e 
r w e R b e g 
