7 7
0
e w e e G e e 
B h B e e g e 
e e y y c w g 
e g f w B e R 
e e c s R g g 
e e e b g e r 
r g e e B b e 
