7 7
0
r f e w c e e 
g w g e w e R 
e e R c e B e 
b g g e e s g 
w R G r e g R 
m e v g y e R 
e b e R y e g 
