7 7
0
c e e w e c f 
R R c y w b m 
e e h m e B e 
G s e e g c R 
g e e e b B r 
m e e r b m r 
e c e g r B e 
