7 7
0
e e s e r e m 
B e m e G e w 
R G c e r m G 
b b R r y G e 
e e b y e y B 
e G r v w b G 
y b r f c r e 
