7 7
0
e y e B e g B 
r R b b e e e 
e r e b G v e 
f y b r g s e 
c c R b r y e 
m y e m b R e 
B G R m e m w 
