7 7
0
c f w g e e e 
R y e e e e e 
e m e g y m B 
e e w c G e c 
c b G e s h G 
e B c e g e e 
e y r e e g B 
