7 7
0
e B r G e m e 
e m c e e e m 
c G r g y R B 
f e w b e c m 
e r b e e s e 
m e c G e e G 
b g r w e e B 
