7 7
0
m R w e b G c 
g e e e w b v 
f g b b e m B 
r y e G b e g 
r g e e r e b 
B R r s e g e 
m e e b r e B 
