7 7
0
e e e G e e w 
e e e b g r m 
c R y w w f y 
B m e c y r y 
b s e e g e r 
w e r e B e c 
G c R w B G g 
