7 7
0
e G m m w B r 
e s e e c R e 
e e g b R B e 
e b G e w b v 
e e r e e m e 
r y B e m m e 
e f r w e e y 
