7 7
0
e B e r c w e 
w s r e e e e 
e b m e y g e 
m e e e b R e 
y e b b B B e 
f r y B e r e 
w G e r e B G 
