7 7
0
b e e B b r e 
e g G e w R s 
b c e e B B c 
e e r R w R r 
B e e y r c g 
e c m h R B b 
r e e c c r f 
