7 7
0
R B c y r G B 
c s m r e e g 
c y R m c b G 
w b e w B e e 
e c B r e c e 
e m c e g e e 
b e f b R y e 
