7 7
0
b g e y e B e 
e e y R B y e 
e g e e c y G 
R m e e e e w 
e s w e c e w 
B e e g e y e 
e e r g B f r 
