7 7
0
e e e R e g y 
b w e e G c f 
e e g R e r g 
e G w e e w e 
e e m r b R e 
e B y e s e R 
g e e g g e e 
