6 6
0
e e m y e e 
B e e c e G 
e e c b e r 
R r G e b G 
w y B r e c 
B e r e m e 
