6 6
0
e e e B g e 
e e e e c e 
R e c r R e 
e c e b G r 
g e e e m m 
e e e y e e 
