6 6
0
e e e m e e 
B e e r B e 
m m b e R e 
e e G y e e 
e B c e g g 
e e e m w e 
