6 6
0
e G e e r e 
e e e y B R 
e e e c g e 
e B b e R m 
e w e g c b 
e b e e g e 
