8 8
0
e e g g r e e e 
R e e e g e e e 
e y m e B w R e 
e e e g G e G w 
e e s e r b g e 
e w e c w r e R 
b e w e f e b e 
G e e w r e c e 
