8 8
0
e y b e e e R e 
e c c m e y B y 
R G m e r r G m 
B e y e e e e c 
s e e w e e b e 
e r g r e e b e 
e b e e c g b e 
e r r e w r f G 
