8 8
0
m g e e c m e e 
c m B b e e e e 
f r e c e e e e 
w r B e G e m r 
w e e e G e B e 
B y c g e e R h 
w B e y c e c b 
e r s G r e g e 
