8 8
0
e e e g y e e w 
e w w f R m e G 
B w e g y w b e 
g m y e b c c e 
B e s r e e e w 
e y e y r e b e 
e e b G e m B e 
e e m e R e y e 
