8 8
0
e G b c e e e e 
R e m B b e r e 
w y e e e e e w 
e e e e e e e e 
e e e R e e B s 
e c c e B g e g 
e e e b e y g e 
y e w R b r f e 
