8 8
0
e e e e g r f b 
R e e m e y e b 
e G e e r e y m 
w e y w e c G r 
e c e e G e g v 
g R c m m e e G 
R e e e B r w e 
r e s e e e e e 
