8 8
0
f w w m e e e e 
e e e r r m e g 
e b w m c b e e 
e g r g e e e e 
e r g w s G e c 
y G G b w e e m 
e e B r R r g e 
e e v G e e G e 
