8 8
0
y G e G b c w e 
R m e b c B G g 
g B e e g b w e 
e s e w e c e G 
G m y e m e f g 
m e G c e e e c 
w g w e y e b e 
e w v e R g e e 
