8 8
0
w y G m G w R e 
R e r c e y s e 
f g e e c e B e 
m v e e y e e e 
G e r w e b c g 
g c G r e e e e 
B e e e e e r g 
g e e e e e g g 
