8 8
0
R G e e y g f e 
b e e e e e e e 
e y y r c c w w 
e e y w b s g e 
G m e b c R B b 
e y e c g b e b 
r g g e e v b e 
r G B R b b e e 
