8 8
0
e e e r B e e e 
e g w y w g e w 
f e w e e G B y 
e b m w r r G G 
w r e g e e e e 
e e e s c e e B 
e e r e R b e b 
e y w e B b e m 
