8 8
0
R c g R e w c r 
w m g e e e w e 
e G e e r e m e 
e e e G w b B e 
e g e r h e w e 
m e g r e g f e 
s G w e e w e b 
w b G R e e y e 
