8 8
0
b e e y e e e e 
s e e e w m f e 
e y e R m y m e 
e e e e y B e g 
c r c b G e e r 
w R e r y e w c 
e e h r e b e g 
B e e R e m B e 
