8 8
0
R y R e m y B G 
e e w f g m m y 
r e b y m c e e 
e e w e b e b g 
m w R g e b e e 
e B s e e e b e 
g e m e g w g G 
e g e e e B e e 
