8 8
0
r G y e e B s y 
G e e c G e G e 
e B b e m G r r 
y e r e e y B e 
G R e m r g c h 
m y b r r e w w 
G m y e e w y c 
b e e w g f b e 
