8 8
0
y m e r b e y r 
R y c e G e e c 
e w m e e R e b 
e e B w c e e y 
e e g e m f r e 
e b e R s w b B 
y e c e e e e w 
b e g r G e e G 
