8 8
0
e g e B c B e v 
b e y y g c e G 
f w e e r e e e 
c e e e b e g e 
r m e G e m r e 
g g G e e e e R 
e e s y e g e e 
w e e R e e e e 
