8 8
0
e r m e f e e G 
c w G e e e b y 
b e g w m r e e 
R r y G B g y e 
e y e g e b w e 
e B e c e e e w 
r e s e b g b w 
e b b e R e w G 
