8 8
0
e e R G e r y g 
e e s e r b b c 
R e e e r g f m 
r e y m y e B e 
e e e w e c g e 
m g g y b e e c 
e B e r w b e G 
e e B e G G r e 
