8 8
0
r y e b e e e B 
r e m f e e y e 
y s m e r e e e 
e e R w e e e e 
m r m R b e G c 
w G e e b y e e 
e e g b r e e R 
e b e R g B e e 
