8 8
0
r f m e e e e e 
e m e w e c e b 
s e e e y m e e 
h G e g m e g b 
e c b e B e e e 
e e r G g e B e 
G g e e w B e e 
e r e c R r e r 
