8 8
0
e r b c e e B g 
e y f g g e c B 
e e g e e g c e 
g m y e e G B e 
w G e g e w R e 
e e e e w e c b 
e e e e e r R s 
e c e e e c e e 
