8 8
0
r e e e e e r e 
g e w r e e B e 
e e R b e e e e 
e c w R e G g B 
e c e b e e r e 
m G e b y w e y 
c e s b e y g f 
B e e g e b g e 
