8 8
0
B e e e y e e e 
e R e e b e w e 
c s b e R r e R 
e r e b e e c e 
e e g y r g w G 
m e c e c f G w 
b e R w r e y e 
e e e e g g c e 
