8 8
0
e R e h e m e e 
e B e e c e G g 
e y e y e G e e 
g w e r e e e y 
e b y R w e e B 
R e r r f m s e 
e w e e m e e e 
c e e B w e m r 
