8 8
0
e e e e w B s e 
B f m r e r w e 
e y y e m m e e 
e e c c e e b r 
e R r e m e e g 
e e G B w e e R 
y c y e g b e y 
e b e B e m y y 
