8 8
0
e e e e G b s e 
e e B e e e e B 
e m e R m e e b 
y g c e y w b R 
m b e b e r e e 
e y y e B e g y 
e e e w c r e e 
b e e e G e r f 
