8 8
0
e e b e e e e e 
h e e e e e r B 
y R e e c g e G 
e r m f e b w y 
w g g c c b e e 
e e y e e e e b 
m G g R e w y R 
e e e R e r e s 
