8 8
0
e e e e e e e g 
e e e e e c e e 
b e r r s B r e 
r c e B w G e e 
e w e e R r e c 
g e e y g R c G 
B w y e R c b e 
e m e e e f m m 
