8 8
0
y r e B c e e w 
B e e h b r r e 
r w R e y f R e 
e e r m r c w y 
s m e e y c g e 
R r e r e e R b 
G e m b e e r e 
e g g e y G c R 
