8 8
0
e G g e e R y e 
e e c e G e e B 
b r e c e b y B 
w e e w G g r g 
G g b e m e e g 
y e y c B e m g 
B g g e r s R g 
f r g e e g e e 
