8 8
0
e e c g c e c w 
B r e e e e e e 
y e w B y b e w 
B h B y s R g e 
R b e c e r B G 
w e b e w w y b 
G g e e w e e e 
e e f e e w r e 
