8 8
0
e e e c e G e e 
m G b e e e b r 
e y w m e w e s 
r e R e w e R e 
w r e e e m e R 
r f y g e g B e 
e e y e e y r e 
G e g w g e e m 
