8 8
0
e B e f m m e e 
e e e R b g e e 
e r b e m e e e 
e e c c e w c r 
e G c g e e R G 
e e r c e e s e 
B e e w e e e R 
e e e e g e e e 
