8 8
0
R e y B r e e G 
e e e e b e e R 
b e e m e y y c 
e e e w c f c e 
e r e e y g e e 
w m w b e h e e 
e s e r e B e g 
e e e R g R e e 
