8 8
0
g e g e w e e e 
e w G e y G e s 
b e c c c B b g 
e c e b e c b c 
b B r e y b w R 
e e r e c e y b 
G m b f G c R e 
e R g e m r e e 
