8 8
0
c e c f c e e e 
r R e c e e e y 
g e c R e s e h 
e e G y B e e e 
g e c e r r b e 
e b e g e e r w 
y e e r e G G e 
e G b B e c e e 
