8 8
0
B g r r e e r w 
b B R e c e g y 
b e e R b e G m 
e e e e r e e e 
r s e g b R g e 
e b e b B y b g 
e e c e e w m G 
e c f y R e y B 
