8 8
0
G e r e e g e e 
e b e y G e e e 
w e e e r e y G 
w R s e e w r e 
e w h b y B y e 
g c G w e e e e 
e m b e r e e w 
e f R b e e e r 
