8 8
0
e g e e g b f B 
e e e e y R g b 
m e e e e c c e 
G b s e c e e e 
e B e c e e e e 
e c r e G y e R 
w e e e e g r e 
e e R e m e e v 
