8 8
0
g e r r m G R e 
r g c e y b e s 
r e c G e e g r 
e e g y g e g G 
e e r e e c e m 
f e c e R g e G 
h e e c e e e e 
r b e r G b e e 
