8 8
0
e G r e m b y e 
e e g e g B e g 
g B e g e e r e 
h c c e e c R e 
R c g y s G w c 
m e e G g b g w 
R m y r r y g g 
B B w e f w e r 
