8 8
0
g g e w e e e e 
r m y f r e B e 
e e g w e s G e 
e e b e b w G b 
e e e r e B r e 
e e w e g e e e 
e R e c m y B e 
r e B c e e e e 
