8 8
0
e w e G R c w R 
e e g b e m b e 
B w e w m e s B 
b r R G r w e e 
g c f e e e g g 
m e c g e e e e 
e R e B B e e b 
y y e e b e e m 
