8 8
0
G g r m G m e e 
G m m e c e e e 
e e w y r e f c 
e e w e g e c e 
B e m e B g r m 
e r R e y b c e 
e e c m m B e R 
g e r s B e c c 
