8 8
0
m e f e w b w y 
r g e m r m b R 
R b e y r c w r 
G G b B m R g e 
m m w b R b r e 
b G B b B e s e 
e e e y e G w e 
e e e e m e r g 
