8 8
0
G R b e w m r e 
w w c B e e e c 
e e m e s c r m 
b G y y y e e e 
e y f w r y w B 
e e c e b e e e 
r e e r e G B e 
e e e G g e e G 
