8 8
0
e g f w G g e e 
B m e B r y r g 
e w y e c r e e 
y y r m c e g e 
m e m r G e y R 
e B r g e y e s 
w e e G c g e e 
e G e r e b e e 
