8 8
0
c f e e e c e r 
b e e G r m c e 
e y r m e e e e 
g e m b m w s e 
c b G e B r e e 
e e R c y e e e 
y e v B b B e e 
e r G r c e e b 
