8 8
0
e g B r G w e f 
m m b s e w w b 
e b e e e y e e 
e G w g c e e h 
g e e e e e e e 
R b e G c e e e 
B r e e e e e r 
m e R G b e w B 
