8 8
0
e R c B c e e e 
r m G w b w f e 
m e e e b r c m 
r e c e g h e c 
B B B r r R G e 
e e y s e g e r 
e w y e e B w y 
e m r R r e g m 
