8 8
0
f m c y b e e e 
b e h e b e g e 
s R y r R c B e 
G e g c e g e B 
e e g c e G m e 
e e w e r e c e 
r y g e e b e e 
e e y e e G g e 
