8 8
0
b b c e r y B e 
b e e r m e e w 
b r e B e B b r 
e g G r e w r e 
f r e e w s e e 
r e e m y B e g 
e e r b e G G G 
e y e e w c G R 
