8 8
0
g b e R y e e e 
e R f e b R g y 
r e e m e y w e 
y m y r e e G r 
e g r c g r e b 
B y g R r e b m 
s e e e m e e e 
R e B e w w e G 
