8 8
0
b e e e g e e R 
e g e c R b b y 
e e e b e B y g 
e e R e c G r f 
e s e y m y e e 
e w e w r e r w 
B e e m e r e e 
e e G e b e e c 
