8 8
0
w c e e g r e y 
e e e R B g f c 
e s e e e e y e 
e e e e e e m R 
e R e e r w e B 
e w g g e b e e 
c e e y e e c e 
e e G m R b e e 
