8 8
0
e G w e e e e e 
R e r c r B e e 
R r e r e e e w 
e m e r y e e e 
e c g e y e b e 
g e w B e y f w 
e g b e e e e w 
s G b c c e G e 
