8 8
0
e R e e y e r m 
B r r c e e e e 
b G e y R e e e 
e B e w c e e e 
e g e e g e w G 
G e w e e g c e 
B e e c y r B m 
e e s e b e c f 
