8 8
0
G b e v e r e r 
e e e e w e r g 
e w m y g g B c 
e y r B G g b e 
y f w e w e g e 
R y c s e c e e 
e e m e e g G y 
r e r b e y e R 
