8 8
0
e e r B e r G f 
e e g e e B w b 
e B G r e e e r 
e G m e g y m y 
b r s g m e g y 
b e e y g e e y 
G e e c e e R e 
e e w e R e e b 
