8 8
0
e e w e c r G r 
y G e e m B y G 
e b e e e b g e 
e f m e e m e e 
e m e e G g e e 
b r w b b e e e 
R e e e e G e s 
w e e e e r c e 
