8 8
0
G c r e e c m e 
B e b f G e y e 
e b w e e e e c 
e R r g b e g e 
e b e e m b e e 
c R b y e g c m 
e e w G e e e r 
s r r h e e B e 
