8 8
0
R e g e w m y e 
R r G e r y e e 
b y e c e e g y 
r g e B m e e w 
e e r e w e r R 
e e b w f b e e 
G B s r w e e e 
g e e e g B e g 
