8 8
0
e c e e G r e e 
R e w e e g e R 
e c e e G e e b 
g e c m b m y g 
y e r s e e G b 
m e g G w w v e 
r e e e r G e B 
f y G b r c b c 
