8 8
0
r v e e b e B e 
y e e e e g y m 
G e e s y e b e 
B e m b w e R e 
R r r e e m e e 
R w e y y B w r 
B e e c y r e y 
e e B w r f e e 
