8 8
0
e e e w y e G y 
r B r e g e e c 
g y e f b B e r 
B e e e w m e c 
R e e g e e c e 
b y y g e e b g 
B e e e e b s m 
e e e e e g e B 
