8 8
0
e e w r e g R e 
w e w r r f e B 
e e g B e y e r 
R e e g e m y e 
e e m g c e e e 
e e y r G e B m 
r G w B e e s b 
e e r e e e b b 
