8 8
0
G e e e e w w r 
G e y y e m e s 
e e e b m G R e 
e e c r f w e y 
w b R y w e b e 
R B m g b c e e 
e e e r e e R e 
e e h e e b e e 
