8 8
0
e s e e r e e g 
e e e c f w y e 
e b e e y g G e 
b e b B r b B e 
e e v r e e g y 
e e G g e e e e 
e e w e e R e e 
e R y e e B e e 
