8 8
0
R g f c e m b e 
e b r e e m g r 
e e e r e g R w 
B e w y c e y g 
r c R g w g e G 
b w e e r e y s 
e e m e r R r R 
G B e e e r r e 
