8 8
0
e c e R e b c e 
e R e b f b g e 
y y r G w r e e 
w e R c c e e B 
G m b e e s e y 
e e c w e w e e 
G g e e e e e e 
e e e r e e e e 
