8 8
0
m g w b w e e e 
r e e e e e e e 
r y r c g c e e 
e b f r B e w R 
w w e w s e e g 
B e g R m g b e 
e e c y r e e R 
G B e w G e g e 
