8 8
0
G e w G e e r e 
g f e w g m B e 
e m r e R e g e 
w y e e e e g e 
e r y c g b e e 
R s e b m R y r 
e e r e e w g e 
e g g B e g G e 
