8 8
0
f r B e e e g e 
m r m e y e b e 
w w g g e e m b 
c e e e m e b r 
b G y g e e s B 
y m c e G e B e 
g w r w e e e e 
e G R e b e w e 
