8 8
0
e e G e e g h y 
r c r G R m e e 
r y e c b s e R 
e G y m B e e R 
R c g b y G g g 
e B e g e r r g 
y e B y b g w c 
e b f m b e b y 
