8 8
0
G e e R e c c c 
c e e e m B e e 
g R s m e e e e 
e e e r y G w r 
e e y y r c g R 
h e e m e r m c 
g e B g e r e e 
G g r e g e f e 
