8 8
0
e b R g G e y e 
e s e m e e B e 
b e e b e m e e 
m r h G c B e G 
e b g r c B y m 
g e y y y B e e 
f r e r e e e e 
e e e e G b e e 
