8 8
0
g e e e y c r e 
R G c e e c e e 
e v e m e B c B 
e y e g r b e e 
e e R w m b g G 
e e s B y w f g 
e g c m r b e w 
e e m r g e e e 
