8 8
0
m e e B y f e r 
e e e e r c w e 
e e e r e G r g 
e e e e g y g g 
e e e h e r e e 
G e m c b G b e 
e e c e e R e G 
B m e s b y e m 
