8 8
0
e r g R b e e y 
e e m G y e e e 
R e e g e w f e 
G e r r b e g w 
e w R e e b v B 
e m e e e r e e 
c e m e e e y e 
m B e e e s m b 
