8 8
0
m e e e e e e e 
e b e e B b e e 
m b e e s e B e 
b G e r c b w R 
e m r m e e B w 
c e m e y y r w 
e e m c e c R R 
m e y f e R r g 
