8 8
0
e m e m e y y e 
e e w e e m e b 
b G G G v c g e 
B r e e b g e b 
e R g g R e e e 
g s e c e e e e 
f c g e e e G e 
g e e e e e e g 
