8 8
0
e G e G m e e e 
g G e y f b w e 
r b B y e b e b 
e m y r b r r e 
e g e g y e e y 
e e e v e e m e 
R r e e r s G e 
B e e e e e y e 
