8 8
0
c r r r e b e e 
c G e e c c r e 
b y e m e e b R 
r w r e r e c e 
e f b e e g w G 
c e e g r B e b 
w e g w m b e w 
B G w e e y s R 
