8 8
0
r R w e e y e e 
e s w y e g g e 
m r B c R G b e 
R g B G g e e g 
w B b m e e g h 
B e g g e e b e 
e e y f y g w e 
e r w e b G b e 
