8 8
0
r b R e B R e B 
G e e g e e e b 
r m R e e w s e 
c e r w r e e e 
b g w g g b e w 
e e r e r g g e 
e e e f e y e e 
e e e e b e R e 
