8 8
0
g e m B e g e G 
b r e m s B B e 
w e f m g e g e 
e w y B B m m w 
e y g e y w w e 
e e R r e e w b 
e e e m y e e m 
R c G b e e y G 
