8 8
0
B R m e e g e m 
e y e g R e c g 
G g R e r s e e 
e b g G m w e e 
e e b e e e e e 
e e g y w b e e 
e g B y w f w R 
e w e b c e g y 
