8 8
0
g b r m G m r r 
e e y m e g y y 
e e r B c e s G 
e e e e e m R R 
b e b e e w e g 
f b G B e b e e 
e r g g e G y e 
m e c c e r m w 
