8 8
0
e e g e e e e e 
e e e e e e e w 
e b g e e e R e 
e c G c g s G G 
b y e y G b e r 
e B e w y e w e 
w e b y e y f w 
G e R g m e w c 
