8 8
0
e e G c e e m R 
e e r g e w R G 
y g g e e y b h 
e c e e y y e e 
f c r b e e B s 
g R B r e e e e 
e r w r e e R e 
c g e e e e e e 
