8 8
0
R e y g m g b b 
e w e g m G s e 
e e e r e m e e 
e r e f b m m R 
b e w r m G B y 
g G b w e r c e 
e e w B c B e w 
e R e e e b R b 
