8 8
0
e e e e e e r e 
e s R e G w e e 
m R e m w e y R 
r y b g f e e y 
e B y m e e e e 
e e e w m e r e 
R y e e c b m b 
e e G e e e e e 
