8 8
0
G e m G e e R B 
e e e m w e e e 
e b y r e g e e 
r w e R s c e e 
e G y e e e e m 
b e c e b e e e 
m b m b g e y e 
e f e w B g e e 
