8 8
0
r G e e g e e e 
B e e y e e b r 
e m m e e e e e 
s y e e e e e e 
w r e e g e e e 
v e r b r e G w 
e G G e b B r f 
e y e R e y b e 
