8 8
0
e e e e B e e e 
e e b R e m e b 
e g e w w b e e 
g e G b e e r B 
e g c e b c e m 
e e e s r g e G 
e G B m f e e g 
m g e m w e b b 
