8 8
0
e R e w s e e e 
y e e r e e e R 
e g c e e e b b 
b y b b e G y R 
g f w e b y c G 
e e e e w R g c 
e e e e G b e w 
e e e e e e e e 
