8 8
0
s e e B y e e e 
e e e e e b B e 
e y g b m e c b 
b r m R G r b e 
b w e g e g e e 
g e e e c e e e 
f g w g e e e e 
e g B e R e e G 
