8 8
0
e e w e B e e e 
g e r c e r e B 
e e e e c e r b 
e e e e r e e e 
B e b e e r e e 
r y B g e e e h 
e b R B r e e e 
f G c e g e s m 
