8 8
0
B b b e e e G e 
r r r e y w e R 
g e e y e B w r 
b e e e e y B B 
e g m w r g h e 
e b b e e e e R 
G R y e s e g y 
g e m b e e g f 
