8 8
0
e e G g w f y g 
b B c g G r e e 
e e b e b r b e 
R e e e r R G e 
w e b r e m b c 
G e r e e e e e 
e g e w e s e e 
e e w m e g e B 
