8 8
0
w g e e e e b e 
e b G e G g v m 
e c b e f r G r 
g b R e r e e e 
B m b y m y y R 
e e w e e e m e 
e s e e e e e c 
y r e G e e m e 
