8 8
0
b e g b e e R e 
e v b e e r r e 
G e e e G e g c 
y e e e c r B e 
e b g y w e b m 
c e g r e G g f 
y B e c e w e R 
e e s w e m w e 
