8 8
0
G e y y e w e y 
e e e g e e e e 
g v R e c e e e 
e b g m y f y R 
r B R R b r y e 
e w s g g R r e 
e w c b e c e e 
r w b b e b e e 
