8 8
0
B e e e r B f w 
e g y r e y R y 
e s e e e c e e 
e b B e g w G R 
r e e e e r G e 
y b e y r g w g 
e R b e w e e g 
e h R m m e e G 
