8 8
0
G e e b G e g b 
e e e w g B s e 
w e y e e e e e 
e r e e e e e g 
e e e y w b e c 
c w w e e w g b 
e b f r e e e e 
c B G m e G e R 
