8 8
0
B b e w f r e e 
e G e e w g e e 
e e m e s w e y 
b m e G y e e e 
c e m c B g e g 
e e e g g e e R 
e b e e e e r g 
w e e B w B e e 
