8 8
0
e e c e e e m w 
e e e y e G y b 
e R e e e e e B 
e e m g e R e e 
r c e y e e e B 
e g e y e b e y 
g e s R g e e r 
e e m e G b b f 
