8 8
0
G e r c c f m e 
b e b v G m e B 
w e c w g r e b 
e e e R e g e B 
e R c w c e c e 
G e R e e e w m 
w e e g e e e r 
e g s g e e e e 
