8 8
0
e w b y e e e r 
g e e e r g b y 
g w e y r G w R 
r g m y G s r e 
e e e e y e g b 
r e e y f b v e 
e b m g b c G w 
b B e R R e g B 
