8 8
0
g e c e e e w e 
e e c e r e R f 
e e m e B c w r 
e w e m e m h y 
y e R w y e b e 
g y y e m e r G 
R s e G e m e e 
e e b e e y B e 
