8 8
0
e e e b e G e e 
e b e e e b G e 
e e e G v m e g 
e e y f y b e r 
w w e y G B m w 
e e w e b e m r 
e G w s e g w e 
e m e y e e B e 
