8 8
0
B c e w e G e g 
e e e R m e e e 
e b r c G g B e 
m b f w b e b e 
e e r g r e e e 
e r e r e s e r 
e e B w e c g m 
r e e e r e e R 
