8 8
0
m e R G B c w m 
c y w r r e b y 
r B r B e B e R 
m r g b g e s e 
b B e g b e B m 
e f B e g e y e 
e e g e G y G y 
e B e c g r e g 
