8 8
0
r B r e e B G e 
G y e R e e e R 
e e w e e e b w 
e b R r e b e e 
e w s w m w y e 
e e g f w b m e 
e e e g e b G e 
e e e e e e w g 
