8 8
0
y e c e r w e g 
e e e e b e G y 
e c e b b e s e 
B e g G r g e e 
R w B b e r e G 
r e e y R e e m 
e m w e e e e e 
f c e G e v w e 
