8 8
0
G e y r e v e e 
r c e b g e e R 
e r e b e R g B 
w R g r e r e c 
e w e b e c e b 
b f e e m e e e 
e b w g e s e g 
R e e e c R m R 
