8 8
0
R e y e B b e r 
e r r R r r B w 
s g r e m y c e 
e e w e e b m G 
r w b e y e e c 
e e c y w G h R 
G b g b e y m y 
g y e f e e y e 
