8 8
0
e e B e y e w e 
e e e e y e g e 
G y r b G b e r 
e y e g e b f e 
c B e s y B y w 
R e m w B e G e 
e b e y g b c e 
r e e m R w m e 
