8 8
0
e f m w G e e y 
e e e b w e B e 
G v w e e c e c 
r r b y b g G s 
e w e e m e y e 
e b e G w B e r 
w g b B e R c e 
c e e b w r y G 
