8 8
0
y y f w e e w e 
c e y e s G r e 
e c e g e h e y 
e e g B c c r e 
g r e B e y G b 
m B m c y e c e 
g y e e R e B e 
e e e e B g e e 
