8 8
0
f G e b e e e e 
e e m r w s e e 
e m y e e e c e 
m e w e w e R G 
e r B g e b w m 
G y e R e v e e 
b e e e e m r b 
G g b e e e e e 
