8 8
0
g g e b c e g m 
R g e e c f e e 
y w R e b m R r 
y B e m m c r w 
b G w r G b e e 
e h c s e B w y 
R G e y w w e R 
e y b c g m b e 
