8 8
0
e b e r e g e G 
m y R r w G e e 
y s e e g e e b 
e e e r w e w f 
r e G e R g G r 
g e e y m e e e 
e b b c e e e e 
G e c e B w e y 
