8 8
0
w e c e e e e G 
G b e e e e R B 
b R e e R c e e 
r e y g b b e g 
e b s B e c e e 
e y b e g b g e 
R b e e g e c g 
c e R g e f e r 
