8 8
0
m c e e e e B e 
b c e e e G m e 
e G e e e e g R 
c e e e c e r e 
e s e b m m b e 
m e B e y y r w 
e e e w c m R e 
g e m c f R r G 
