8 8
0
g e b r f R e e 
g b w e e e r y 
e s y r g b e e 
e e y e e e e R 
R w c e r e e e 
r y w y g w m m 
B e c e e c G y 
e G e m G e w r 
