8 8
0
y y m g e e m e 
e e g b e e w c 
s e w e e B m y 
G e e r e w e y 
e c c e e r r m 
e b g g e r c f 
R b e m R g B c 
c R R e e y e G 
