8 8
0
e e e e R e w c 
e e G e c e y g 
B e g e e y w G 
h e e e r g e b 
s e B e w R c e 
e m e c b b e e 
e e c e y f e m 
G w e e r e e e 
