8 8
0
G B m e e b e e 
g e f e y b g g 
G b g c y c c c 
R e w r m y e e 
r c B c B e e e 
m e c e g R e s 
e e e e r b c r 
r e e e e G e e 
