8 8
0
e e e B m e e r 
R e e e b m B e 
h e e e r y b R 
s e e g m r e e 
g m e w e e r b 
G e y e e e e e 
c B c e y e r R 
e m e e r f r e 
