8 8
0
e e R e e e e b 
g w e G y e e b 
e e y m f g b g 
y e R y g b e G 
e s R e m e e e 
e r e w e y e b 
R e e r h e r B 
w c c g y B r c 
