8 8
0
B e e e g c e e 
G c e b B r e e 
e y w b b G R e 
e e e w e g e e 
s b w f y e e e 
r G e r e e B w 
e e e e e e e e 
e w e e e e e e 
