8 8
0
e e e s e e y e 
e y y e r e e g 
R g B g B b y G 
c r e e R c e m 
B w e e m e g y 
y r r e e e e e 
e B y r c e w m 
e e f b e e e e 
