8 8
0
e g m b e w e R 
B y e g B w e e 
e e e e b g f r 
c y g R e g w e 
b B b b w e g G 
B e r s w m m w 
e b G R c G m e 
B e R g e e e g 
