8 8
0
B e e e e e e b 
e e e c y b w r 
e e R b e e e e 
g e m e B G e y 
f y e m e e e c 
b e r G r g e e 
e y w w r s g e 
y e e e G e g G 
