8 8
0
e B m e f g e e 
e b r e e b b B 
e g e e b y g g 
e e b e c y e R 
e e G r r B r e 
m b g r e e y v 
g e r e e R m e 
G e s g r e e b 
