8 8
0
e e G e e e e e 
e c e e m y e G 
c e e w e e e s 
B e e r e w B m 
r c G e b e e e 
R R w e g e e r 
r y G r g e G e 
f e y e w e e B 
