8 8
0
R r c w e r m e 
b R e y b y e B 
b w e c m G e e 
R w e e m f e e 
c B b r e r G b 
G y y g e e B b 
e s c c g b r e 
e R b b e e b c 
