8 8
0
w e g w e e e e 
r e e h g e B e 
G m e e y s w G 
e e r R w e c g 
e G e w w w e e 
e R B c c e r r 
e e f w e g e e 
r g R e B e e e 
