8 8
0
e e b e e b c b 
g e G b b e R y 
e B m g e y g B 
r B e m e e e c 
f m g e e e e c 
r e b e e e e e 
y e y b G e s w 
y w w B e g e e 
