8 8
0
g G r e e m e e 
m e e e m y c y 
m e B B c G y b 
b e y e e r e B 
c G w w r f y y 
R B y s y y B e 
r g e B g B y b 
e R e e e h e g 
