8 8
0
e e R e m e e G 
b w r b b e e y 
R e s e G e r w 
e w e y w y e e 
e b w e e w R e 
b e e c b y B y 
c f e R m e y c 
e g c b r e y c 
