8 8
0
e e e e e e c m 
f e g e e w e r 
e R e g c e e r 
e e g e e b B e 
y y m B s y m R 
R r e b c b r e 
m e e B e h e e 
e m e e c G e e 
