8 8
0
e B e b e e y g 
e e y e g e e G 
e e b e R m g r 
w e e e e w R e 
R v b e m e e e 
R e e e c e e G 
e m e e y e e m 
s y e y f e e e 
