8 8
0
e r b b y e c e 
e c b f R w R G 
m B y g w m c m 
G r b g b c w G 
e r e r e w e g 
r r r G B r e e 
w e y w e R e s 
e B R e g b e e 
