8 8
0
y B e e e g f w 
w c e b y e b e 
R e w m r r y e 
s r e w y e B g 
e B m e B e y e 
g b B g e g e G 
e g e e e e e h 
e e e m e g e e 
