8 8
0
e G w e e e y e 
e e B e y y e m 
R e G w e e e e 
e e m w e g e e 
e e e w G e s e 
b e w R e w m w 
e e b e e w f y 
e r e G e c e r 
