8 8
0
e w m y b e e g 
R e w s R c r e 
e r e e e e b f 
e R c e m c e g 
e e c g b G e G 
e R e e y e b g 
e e e e r e e m 
e e e m m R e w 
