8 8
0
e y e e y e G g 
e e m e y g e e 
e B y e w e r e 
e G w c b v b R 
e s w r m e e w 
e c e y e e r e 
m e e b r g G f 
B e G e g e e e 
