8 8
0
e b e y c e e g 
e e b g e e e e 
g e e G e e e g 
e e R r e m e s 
r b b e m f w e 
e B r e e c m e 
v g R e e e e G 
R w e e e R e e 
