8 8
0
B e f h m b b b 
e b g c e e e r 
G g B m b e c e 
c m m g e m e r 
y e r e e e y r 
e e B y r e y R 
e e e c e G e e 
w e G G g s g e 
