8 8
0
e b e e R e e b 
B e g r e e e G 
g e R G r s e e 
b e r c e m e g 
B b e g y b b e 
g e b R e e m e 
e e b c c e e c 
B r e e e f e e 
