8 8
0
e f g e e w R g 
b g g e r s y e 
e e e w b e c R 
e e e e w e e e 
e e G e g y B G 
w e m g e e c c 
e c G y y g e b 
e b e e e e G e 
