8 8
0
c e e c y e v R 
e e e e e e g g 
G e e b r m R w 
e e g g s g y e 
e e e e R G b e 
c g e e e e g e 
y m w e e b e B 
e f c e w B e e 
