8 8
0
e e e f m b s e 
e c e c e r e R 
e y G y m b e B 
m m e e y B w r 
e e e w e b m G 
c e e e c e b e 
y e G e R e b r 
e e e e w e e e 
