8 8
0
e R R r m e r w 
e G b e G R w e 
b y b s e m f e 
e B e c G m b e 
e e c e r e g c 
b R e G G e y e 
e e g y r e w y 
e r e e e c g g 
