8 8
0
B e e e e y B e 
m e s e e G c v 
e w g e b b e e 
e G e y e e e R 
e e e e e r G e 
m r w e e e e e 
b f g c r e w e 
r e g R y e e w 
