8 8
0
B R e h y e e r 
r e e g r G e e 
R e r e s e y g 
m e y b w c g B 
R w G e c e G e 
e e g e e c m m 
m g w w e m R R 
f r m g e e e e 
