8 8
0
r m G e B m G w 
e e g c e y e G 
e e e m e e e e 
G e e e y b e c 
e e s g r e e e 
e g y e m w R c 
c e R r f y m e 
e e b g b e e G 
