8 8
0
c g r w e y w e 
y y e w e e e B 
e G e e e b c r 
b e e s R e e w 
R e e b b e r y 
e R m h e g b g 
e w w e e y R B 
e m R g R r f e 
