8 8
0
e R y w f m e e 
y e w e w e e e 
e c w r e c g B 
m G w e e e b e 
e e e w e G e y 
e e w e b e B e 
e e B g B c s e 
b r c b R c e c 
