8 8
0
e B e R r e c y 
G e r w w G e g 
y b c s R r w e 
e g e e y w e c 
e e c g f v e e 
e e e y r G e e 
m e e e b e b e 
e e B g e e e e 
