8 8
0
c e c e e e g f 
b e e w e R g c 
e e c B e c b b 
e e B s c G e e 
e e e g m m e c 
b e r B e G e e 
g e g e e e R h 
e e r e b e e e 
