8 8
0
G e e e b b r g 
f e e e r m g y 
m w r r e y e y 
e R e g m r G g 
e m R y e e e m 
B g r w G m B b 
g e g e c e e R 
G e w r y s e G 
