8 8
0
e g B e e e m R 
e e R e c G s e 
e w e r r r e c 
e G y e e y e e 
b y c e c r w y 
e r f m e e e c 
e R e r e e e e 
r G e e m e B e 
