6 6
0
e e e b f r 
e e e r m B 
h b e e g e 
e e h v r e 
G w G r e G 
G r e c e s 
