6 6
0
G e e e w e 
e y w R e h 
g e B m m c 
R s e g e c 
h B g G c B 
c b r y m f 
