6 6
0
e G g G B m 
R e y s e G 
h g m m b r 
g r v v m c 
m c w e G g 
w f G c w e 
