6 6
0
m G e e e c 
y G e m R m 
B c g y c r 
e c h e s G 
w f b e e e 
e c e R h e 
