6 6
0
e h b e B r 
s B m e g e 
e g f g e e 
e e c e e R 
m e b e v e 
w h e y B B 
