6 6
0
w R y v e b 
e e r B s h 
G r b B e m 
r h e e R e 
B e g c g e 
c c f m g b 
