6 6
0
f e w B e e 
b w y b R r 
b B b e e G 
g b e y b v 
c G G v e m 
B g s h e v 
