6 6
0
e G e R c e 
e e B e e B 
r w v h r g 
e e c g b f 
s e e c c v 
e c R e g e 
