6 6
0
b f b R s g 
e r e c G b 
g v g g r B 
e r G e b e 
e e c e r B 
B e B e e r 
