6 6
0
w e e e G g 
r s c c B e 
G r c b g e 
y y R e r e 
r B e m R w 
e e r f e v 
