6 6
0
y e e h f w 
e y g h e r 
R G e r e c 
h e e m m B 
e b m G y e 
r v B e b s 
