6 6
0
e m w r e e 
f g e v v B 
g b e e h e 
B s g h e e 
y c g g e B 
e B e w e G 
