6 6
0
w G e r G R 
e y s e b r 
e h r g G e 
e g f c e R 
y G w c h m 
e g h e e y 
