6 6
0
f b w e e h 
b G e c e b 
y b e r s e 
m e m w y e 
B g e e R B 
e e e R e e 
