6 6
0
b c g f m g 
R e b w y e 
e b h e s R 
G w r R v e 
e y g e m e 
g B v w y G 
