6 6
0
e v e y r h 
e e h r y f 
v R w G r r 
e w e e B e 
R e b g s G 
r B y e e y 
