6 6
0
b e e e r f 
e e B r r c 
w r b e w r 
B R c s G B 
v e b y e c 
e h e e w G 
