6 6
0
s e e y h f 
e e m h m e 
G e r b e m 
e v m R g e 
e G g B G b 
e m e g e e 
