6 6
0
e e f w m e 
r r w e e w 
e e h e s e 
e v e m g b 
e B c G e m 
G y g e B R 
