6 6
0
R g m w w e 
y v e G B s 
c w e r v w 
e e w g b B 
b b b R w y 
g G h f e e 
