6 6
0
c b e s c e 
r e e c e B 
G e b b v e 
g e v y e e 
e w m h e f 
R B m G e b 
