6 6
0
f e m s e e 
g b r G e R 
h e e w e m 
e e B c e e 
G c m e y e 
g e G r b e 
