6 6
0
e e e B e b 
e e h e G c 
e g r y e R 
r B G e y g 
e r s e e b 
y f y e e e 
