6 6
0
c e e B h v 
G m g e R e 
e b e R s m 
e c e r B c 
e e m e w h 
B g B b f m 
