6 6
0
R w v R e h 
e e b e B e 
g e G g s e 
e m m B m e 
g w R g e g 
f g m e e e 
