6 6
0
e e h h e B 
c e e e w e 
e g h m f c 
e r b h m r 
G r r e e s 
G e G e y G 
