6 6
0
e e y y B y 
R e e e g w 
w b e s b m 
e f b G r G 
r h e b e R 
e e e e y c 
