6 6
0
e e c g e e 
B b s e e B 
v c g R g g 
b e m y f r 
v B B R b r 
e r e G e b 
