6 6
0
v e B e e R 
g m y r m w 
s w m c g B 
e e R b G v 
y r G h b f 
w g G r m v 
