6 6
0
e B e e m b 
g s e w G B 
e R g y m r 
e w b R c g 
c e B r b f 
y v G e B m 
