6 6
0
b e R m w e 
v e B w h e 
e c w e g f 
g G r b c m 
B g e e v b 
G e e s h e 
