6 6
0
e f r e e R 
g g c B e b 
e B w g b G 
e m w G g s 
y w e R h b 
w e B e e e 
