6 6
0
v R B r e R 
g R r e e y 
e e r s m c 
g e h r c r 
e w b R G g 
f G c e R w 
