6 6
0
h e c e B e 
v e r s e b 
e g b g c B 
m f e r B G 
e e e b w c 
h e w e e R 
