6 6
0
y e G e m e 
e e v w h r 
R w r s e b 
f h g B y R 
r c b w R G 
b e r v e B 
