6 6
0
B e e b e v 
e y f c g m 
v e r h h e 
b G g B s e 
y w e r b m 
R G e e e g 
