6 6
0
G w G e b g 
e e s b f c 
R b e w b b 
y e g e e h 
e B y B c h 
R c h c h y 
