6 6
0
h G R R c y 
B m m y G b 
y y s R e g 
R B b c r h 
m c R R c y 
m b B r r f 
