6 6
0
e e y e R e 
h G B v e e 
e y e e e g 
w g r m y G 
r G e e c e 
f b m e w s 
