6 6
0
e b c B w e 
e e R e e b 
g s b e c G 
b y G y e c 
f r e R b h 
e r b e m e 
