6 6
0
R s e g e B 
h b h R e e 
e e y e e e 
c w G w e y 
g f y e b h 
h b e B m e 
