6 6
0
B e m e y e 
y e c f R c 
e e c B v h 
b e s r g r 
B r w G e e 
v e e e r e 
