6 6
0
c v B y R e 
e w R w e b 
B b c e b B 
c e g v b G 
f r e c e s 
h c b e e e 
