6 6
0
w e e e e R 
b g y g B R 
G R w R c c 
y b c c g w 
R s B y f G 
g m y b b g 
