6 6
0
f w e c B v 
b R s g h e 
b e e e r e 
e e b w c y 
e r e c v G 
G e e y R v 
