6 6
0
g B s w G r 
R b B m w g 
y e G m b e 
e m y h B G 
b e b y e e 
g e e B f y 
