6 6
0
r e y v B r 
b e e e e e 
r h e e g e 
e m R r w R 
f c r s e g 
e c e m G B 
