6 6
0
m h b v g e 
e e e s w e 
G h R y c c 
r h e b e R 
R c y G e B 
r f c w e e 
