6 6
0
h m r r G e 
b h R y e R 
e r G g b v 
f B g w b y 
w v w s R e 
g r g r G m 
