6 6
0
e w e g B b 
e w e B R r 
h e w w b s 
e f y G m B 
h e e c g b 
e G e c e y 
