6 6
0
g r h e v y 
e G e e B y 
w s r e r w 
e w e e e g 
R G b e e w 
R g e v m f 
