6 6
0
R m b e e v 
G y G y h e 
g e s g m e 
c e r G g R 
G b e b b e 
y e m e f y 
