6 6
0
G b b e e e 
e e e s v e 
c e R b e e 
f m e m c e 
e y r g e R 
r y m B R y 
