6 6
0
v b w r e e 
s e e m e y 
R e e c e G 
r b h h w f 
e R r c e g 
g B e r e R 
