6 6
0
e e e r G e 
v g w w e B 
m s e e B r 
v r y e g e 
R r e c R G 
f e w m B e 
