6 6
0
e h h h r w 
R e r m R B 
c s y m b e 
B b w c R c 
b w f m G r 
B e R g c v 
