6 6
0
r s r R e y 
B G r e h h 
b m g e e G 
e m e g e r 
e m e R w f 
v b e w h e 
