6 6
0
v e R h v b 
m e B e y R 
e r w c e e 
f R c y G e 
B r m e s c 
w g e g w e 
