6 6
0
B e e b e m 
e R w G h e 
s g c e h b 
c G y g e R 
f y e e v c 
r g e g e e 
