6 6
0
f w G e e e 
B r e g h b 
c m B e e e 
m w g b s c 
h e e e r B 
h r c h R e 
