6 6
0
h e e e s e 
e w w B h B 
G b g e e y 
g b R y m w 
m B y f R G 
R g h r h y 
