6 6
0
f c e c R G 
y e y g r e 
e g v r e R 
b R w y s v 
e G w B w r 
c v e G G w 
