6 6
0
e e y b e e 
e w R e s r 
f c R h e c 
g m e e e B 
e b e e b c 
B B r e b G 
