6 6
0
e e w e g m 
e r e s y f 
h e e e c g 
R m e m e e 
b B B e c e 
w G e y G e 
