6 6
0
G b g h e g 
b e r y m h 
c f r c e m 
b r y s v w 
R G b e e G 
B G w G r B 
