6 6
0
h e b e G e 
e e R b B m 
G c s h g e 
m g c g R h 
f e w c e e 
e c e m w e 
