6 6
0
e B b g r r 
h g e R e b 
r e e e y f 
e h s g e r 
b b r r g e 
B R G v y e 
