6 6
0
w e f h e g 
e y v v m G 
e w r m R B 
b e w e e g 
B s c e e e 
e G m e v r 
