6 6
0
f g g b s v 
m e e e e m 
G r R e h e 
e w y R y e 
r B G c B g 
e e e m r e 
