6 6
0
e e s b f e 
g y G m e g 
B e r e e b 
e b e w c g 
G R y v R m 
v m e e e e 
