6 6
0
R h R h e y 
e m r g r B 
e e G G s m 
e w e r r y 
w f w w g e 
r r G e r e 
