6 6
0
B w e B r h 
f m y R b R 
c c B b e e 
G g y w r e 
e e c e s G 
e e e m e r 
