6 6
0
e y e y y b 
g G r s e e 
R b r g e m 
v y B w B B 
v c w G y R 
f g v c g e 
