6 6
0
g m e r B R 
m r B s y b 
h r G c h R 
g w b y B e 
r e R m r c 
c e e c f r 
