6 6
0
G e e h r e 
g G w e h e 
e e w R b y 
w B b s e m 
G r y e m f 
y m v y g v 
