6 6
0
r e c r e w 
B R s v B w 
m w e e y r 
y f w m R h 
w g B w m B 
e e y g G w 
