6 6
0
f e w y R e 
e r e h g e 
r G e B w e 
e b w y B r 
e s e w e e 
e e B h c h 
