6 6
0
e R e v e G 
s b y r e c 
e g e e m e 
m b R e b v 
f v c g e e 
h e e B e R 
