6 6
0
b e m e s B 
e e b w m R 
v e b g e c 
h v b r y B 
R r e e R e 
m e e v e f 
