6 6
0
m f r e g h 
e g e v B h 
B e r b R e 
s c e c e r 
h e b b w e 
y g e B G e 
