6 6
0
B g e e r f 
R g y m e m 
c e e B w y 
s y e c v e 
G e e y e R 
e e b e e e 
