6 6
0
g m e G y f 
e c B m e R 
R r s g b e 
e r r w e e 
e G v R v r 
m w b y c v 
