6 6
0
b g w r c h 
R G b v s e 
B h w r R e 
B b b e e G 
e y e h c m 
r g e G b f 
