6 6
0
e r y f r r 
B c R g R B 
e b B e y R 
R v b r e c 
G e m R e e 
y e g b s r 
