6 6
0
e e s w m R 
e e e h b e 
e v B b m B 
v y y w R m 
g e y e g G 
y b f G m e 
