6 6
0
e v y e e e 
w e y s G e 
B e b e R e 
R y g y m e 
G e r e v m 
e m e w c f 
