6 6
0
e e e e G R 
g B b b w g 
B r e G s r 
G e g e G w 
b e y h m c 
e r b e c f 
