6 6
0
e R e G e r 
r w b e e c 
B e e h e B 
e B c r y e 
h e b s R c 
e e c m c f 
