6 6
0
c c B g e f 
c e e e g g 
R b y r e r 
e y b s e e 
g G B w m e 
e e h r B R 
