6 6
0
R h e g r e 
c e G e e m 
e m w s G B 
b g m e e e 
e w e m g g 
y f b R e B 
