6 6
0
b e e B g g 
e B e r e B 
v e B w c e 
e e r e e b 
e e y G s B 
f y b e y g 
