6 6
0
r b B v R R 
e G g e e b 
w B g e e e 
G c y y s g 
m r e e w m 
e r r f G m 
