6 6
0
r G r m e e 
s y g f e e 
R g b c e e 
w e e e c R 
e e v r e e 
G R r y e e 
