6 6
0
e B w y B m 
e g e h w r 
c m w R G e 
s c B c R b 
e e y w h f 
e G B m e y 
