6 6
0
b e e e w e 
e y e e s e 
f c b e R e 
c h e g r e 
e e y b e r 
G R r e R B 
