6 6
0
c g e e R h 
b B g e G r 
f w r c g e 
c e s e B e 
h v e e e c 
c m R e r b 
