6 6
0
f e w b R w 
w g s y c e 
e e e y G w 
B e w g B v 
R b e e e g 
h b g e h e 
