6 6
0
R e c y R B 
R r c s e g 
B b r e b e 
e e b h c c 
e r y w b b 
w f g R g e 
