6 6
0
G e f h e g 
g r h c c e 
e G w e B b 
v y e e s R 
R y e r y c 
m e h w r e 
