6 6
0
e b e e e g 
B e e e h e 
B G b g g R 
e g s g w y 
r e e e m f 
R e e m h b 
