6 6
0
B w h f r G 
e c b m B r 
b G c h r h 
v r r e m R 
B m w e e e 
b B s y e G 
