6 6
0
m f R g e c 
e b w e r G 
b g e b b e 
m e e R c R 
w b s v e c 
R m e e e B 
