6 6
0
r y e e r R 
e e y e s G 
e g b g b m 
e R w y e e 
B e g e m f 
v c e e B e 
