6 6
0
e e c e R r 
c e G e b g 
G m s r B b 
b h w e m B 
f g e e B e 
b r G y e w 
