6 6
0
f m e e m e 
c e s e G b 
h g e e b m 
c b e g G e 
e R y B b R 
e b g w v B 
