6 6
0
G e c f b e 
e e R m g R 
e g e s v g 
m g g w v G 
m B c e m e 
h m B R v m 
