6 6
0
v B v v e e 
g h m m e B 
c b G g e e 
e b s e w G 
e g y e c c 
b B f r R e 
