6 6
0
c g e G e B 
e e r c B e 
e R r e c b 
s y g G b y 
G e e b r e 
m y h R m f 
