6 6
0
g w b e m v 
e g R e m f 
B e y e c m 
h r m w s R 
e G m e e g 
e g G G e h 
