6 6
0
r y e c e e 
e b m f w e 
e c R e m e 
v g b e m r 
G B y m s e 
w m e R G e 
