6 6
0
e B f m r e 
e e y s h G 
w g r e e e 
r R e r B w 
e e B b g e 
b h h v e c 
