6 6
0
c G b r m G 
B r b b w b 
B e s v v y 
B g c w g B 
e r g B w R 
y R c f v w 
