6 6
0
B g B r g e 
r R G b e w 
y g h b h b 
e G r e B g 
y g B v y f 
y r e s e w 
