6 6
0
R e e c G e 
w e e v b e 
e e y y e B 
g w e s e m 
B y G e m h 
e h y v y f 
