6 6
0
f G v m e m 
R r r y y e 
e c e e c s 
B m e b e G 
r r g B r e 
y e w m R G 
