6 6
0
e f h w b b 
m m m e b G 
e e R B m e 
w r g c e s 
e e w g e v 
B B e B e w 
