6 6
0
s e g y g e 
b e R R e y 
r h m h c v 
G y b e w R 
m e w g y G 
R g f h e e 
