6 6
0
h y G B e e 
e h r B s e 
f r e w c e 
y g h e B g 
e e b R e y 
c e e r c m 
