6 6
0
B e m w G B 
e e h e r e 
m e G b e r 
f r e s e e 
y b e e v e 
e R m r e e 
