6 6
0
e R g g s e 
R y c r v e 
G r r G g e 
e b m g e e 
r G y e G w 
h m f y h r 
