6 6
0
e r e b e f 
e e e v w w 
e r m e r b 
w s e e m w 
c G e r G B 
R w e g R G 
