6 6
0
f y e R w e 
w r B s r v 
e c e e y e 
G g w r y r 
e h g b R G 
y G r e R y 
