6 6
0
B e y y r e 
f y e e h e 
y e e B e e 
e s m e y c 
e e c b G y 
e R m B r e 
