6 6
0
R s m e v e 
B g b e R m 
y e c B e b 
e f g h e G 
m e e g e e 
e e b e v h 
