6 6
0
e R e y e e 
g g B B e c 
g e y b r v 
m b G e g B 
R e y e s e 
c g f y g e 
