6 6
0
e v m e s R 
y e G c e B 
f b e e g e 
e G y v e y 
h e b e e m 
b r e e B e 
