5 5
0
s e e e e
e e R b v
e e e b r
e e e b r
e e e b f