5 5
0
s e e R b
r m m m b
e e b b e
B e b e e
e e b e f