12 12
0
e e B e c m B c B e e e 
b r R b e y G m w e r g 
e e b e e w b e e e e e 
e y e w e e R g e e e b 
b g w m e e e w g e e e 
e B e r r w m e e R b r 
g e w y e y g e y e e e 
e m e g R e w m R y w e 
c e r e e g b e e e e y 
y c B e w e e w e w r e 
e y g e e R e w y e G e 
r e r e e e y e e R g e 
