12 12
0
e e e c R G e b B G g e 
e R e e r g e y e g e G 
w e r y e e g g r e w c 
e e b e e e e m e B c e 
e e R r e r e w e e y c 
B g w b m e g e e e g e 
y e R e e y B c w w B e 
g g e w e w e e e c c r 
r e e e e e m r m e b e 
e e r e e c e g e r c e 
b e b e e e e e w e e e 
e r e e e e e b e w e e 
