6 6
0
e G g R b G 
y c B e r R 
e e g c e e 
c y w B r y 
e e e c R y 
c g e e g e 
