6 6
0
e e B g e e 
B b e w B G 
R g e e b e 
c B g y c e 
e e e r r r 
e e e w b e 
