6 6
0
e e e c y e 
e e b y G e 
G c G c e e 
R r e b e e 
w c y e b e 
B e G c g e 
