6 6
0
e m m G e e 
e b b e g c 
e R e y R e 
b g B y G e 
R r w e e r 
r R e g y e 
