6 6
0
e e e e e b 
w G e e w e 
e r G B m B 
e B b y r e 
b G b e e w 
m m R m g e 
