6 6
0
e e e c e b 
e e B g G R 
w e e r R r 
G c G m m e 
m b r g e y 
e e G e w e 
