6 6
0
e g e b B e 
G b G e r e 
m G r e B r 
G c e w e r 
g R c R r e 
e e b e g e 
