6 6
0
e e y e m e 
r R e e w e 
e c c m B e 
e e m G g w 
w R B w G w 
r b B e c e 
