6 6
0
e g e c e e 
e m c e R e 
e c e e b e 
R y r b G e 
B r g e e c 
y G c R y e 
