12 12
0
e e c e e e e b e w e w 
e m e r e e B e m v e e 
g m B y e e e e g m e R 
e c g w s e G e e e c e 
r y e c b e e e e r G e 
y e g c e c e e e e c B 
R m e e e e e b w m g e 
g e e e e g e e e e e c 
e e B e w e e e e m e y 
w b r w f y e y e m c e 
R e b e y c g g e e e g 
w B e e b G e g e e e b 
