12 12
0
w y e e h f m e e e B e 
e e m c e r e y e e c e 
r e e e g c e e e c w e 
e b e e B e c e e e e e 
e g w e B e B e e g e w 
m r e e w e e e e e e e 
e e G r r e e g r e w e 
e e y B y e y e w w e y 
r c e m e e b B e e e e 
e e e R e y e G e e w g 
e e e y G e c y e g c s 
g m e e m e e e e e w G 
