12 12
0
f e g g c w w e e w c e 
m c r e e e B r e e c R 
g e g e w b r e e e b w 
e R y e e G c r e g b g 
e e e e c e y r g e b g 
e e w m e y e b e e e r 
r e g e e e e c e g R r 
G b e c e e m e e e g b 
R m e e R m G e s e e c 
m e e m b e e w e b y r 
e R e r b e e e g B e e 
e e c e b e e e v r e G 
