12 12
0
e e e e g e e c e g r f 
e e e e e R g e g v b b 
e R R g c c e e e e e e 
e e e e v R y G e g e e 
e e e m s R e m e m r y 
e e e e e b e e y b b y 
e e e e g e e g e b e g 
e c e y e g G m w c e g 
e e e e G e r e e r e R 
e m r b e B m m e e e e 
g G r e c b e e e e e B 
e e e r e e y b e e e g 
