12 12
0
b e e e e e c e r e e e 
e e G e e r c r e w m g 
e R r e R e e w e e c e 
m G r c e R e R m e e g 
e e b e e e g B w b e g 
e w e w e b e b e e R e 
w e e e r e e R e e e w 
e g r y b e s e c e r R 
e r r e e e g c r g b c 
e m e e e y g e w e e e 
e R e R e y e m c e m e 
c e e e e e c w f w y e 
