12 12
0
c g e e B e e e r e e e 
v e e y G e e e b e e G 
g G e e e e e e e w r e 
r e s e e e b e b e e c 
b r B m r e y y r e g e 
e e c r g e G m e w f b 
e c B m r y v m y G e e 
e r r e m g w b B g b e 
e m e g e e r e e c m e 
e e e w r e w v e e b G 
e e e e e e r e b e b r 
R e e w e w e e e g e c 
