12 12
0
e G m r e e e g e e c e 
G e e f r c e e e e e b 
y e e y R r e c e v m e 
B g r r c e m g e e e e 
b e e r b e e b b e e e 
e e e c e e w B e e G g 
e e c y w b m s e w e e 
e e b e r e e g e e y e 
G B e e w e m e b w v w 
e g e B y e r G e e e e 
e g e c R g e g e c e e 
m c e r b c e e m e e G 
