12 12
0
G e e g m e e e e e e c 
g e e e r e r e e e e G 
c e s e w y g R b e e e 
y e e v g e c e r e g g 
e e c c b B r m R e g G 
c e e e m B m e m g e G 
e e e G w w y b e c g e 
e c e e e e w w e R e e 
c b e e y c y e e B e w 
e R g e r e e r r r f e 
w w e e y r e y w e m e 
e e e m e e m r e e e c 
