12 12
0
e e r e e e e e e g e e 
e e B e e e e e e g e b 
m e e m e e e e e c v e 
e e e e e G m r e e b e 
e e e e s e r r e e e e 
e e w e e g e m r G B r 
b m e e e e e e B e r r 
e y e R e G e e y y e b 
w e y c g e g b g e e e 
m e e g B y b r e e e c 
e m R v b e G e e h e e 
f y c e R B e e e e e e 
