12 12
0
e e G R y g e G e g e e 
b e e e b e e e e e g R 
e e G e w e e e e c B y 
e g m b e y b m g B e r 
y e e b e e e g G e e e 
e y w e e e e w e e e e 
e e e e s e m e e e e e 
r e w B e B e c e e e B 
g e e e b e g e r e e r 
e e e e g g m e b e m e 
e y c c e e e w y r y g 
m g b e e w e e w f e e 
