12 12
0
e g w e b e w e b s B e 
G b e r G e h R e w e e 
e e e e y b e e g R e e 
e e e e r e r v e m b G 
e r G e w e e r w e w r 
b e e y g R e w b b e e 
e m c e m y b c e e c m 
e e G e r c y y R w e c 
e e R e e r e y e e e w 
e e m e e w f e e m e e 
e r c e e e v e e c e e 
b m e e e e e e e e c w 
