12 12
0
e e e e e m e e e e g w 
e e e e m e b e e e B c 
m e e m b e w e e e e e 
c e e e G B e m G e e e 
e e e r e e y g s b w g 
y e e e c g c w c e e G 
y e e w y b g R r m e e 
f r c e w e m e G e r B 
e b c e e y e R B g e e 
y g e e g y b m c e e e 
e e g e y e e B e r c e 
e e e b e e e b r e e c 
