12 12
0
g f e m e e e e e G e y 
e m b e c e g b e b c e 
r e e G r b B g e e e c 
e B e e b g b G y m y e 
c B g h w e e e r w r e 
c c g e c e R e y e e e 
e e e y e y y e e e e e 
e e y r e e b e e e e g 
e w b e e e g e e e e e 
e r e e c s b m B e b w 
e e e e e e e r R b G e 
w w g g c c R r e e e y 
