12 12
0
G e e B s e e e m c G e 
g m e g e e e r e e e e 
r e r e g g m e e e w e 
e e e G e c e e e e m e 
e e g w y w e w e e w y 
e e b e c b c e y e c e 
c g e e c B e B m b y e 
g e e e b e e b c e y e 
B e G e e r g w g r e e 
e R b b e c e e w r e f 
e e e c c e y e e g r e 
e e e e b c G e r e G e 
