12 12
0
f e y e e e y e b e e e 
r m e e w m y e r e w e 
b g B B g e e c e b e e 
e e g m e e w e e e e e 
e B e m g e e b c e e e 
e m m r e e w e R m e e 
e e y m r b e e w g e w 
r w e G e e e e e e e e 
B e h e e e R e w r R b 
e G e b e G e e e e c e 
r e e e e g e e e s c e 
e b w e e G e e e e e e 
