12 12
0
e e m e e e e e e e e e 
e e m e e e e e e B m m 
e e e e g e e e e e w r 
B e y e c e y e e f m m 
e G B e e b e m e e e e 
e e g e e r e r e e e r 
e r e e b e c g y e v e 
e e w e b R y b r r y y 
e e h r e b R g G e e w 
w e c e r y e e m e e G 
e e e e e R w m e e y s 
e e R B e e e e c e e y 
