12 12
0
G e c y B e e h e e r r 
r w e e g e e e e e m e 
g g w m e r G s e g e w 
g c g e e e g m w G B e 
f m e b R y e e e e w e 
m B e m e g e e w g e y 
w e h e y b b r B e e w 
e r r e w y e e e e G e 
e e e e e B c g b c e e 
R e e e e G e e r g e e 
r e e c c r w h r b e e 
e e e c b y e e e g e e 
