12 12
0
r e e w m e w y e e e e 
e m w c w e e e e e G e 
B s b B g e e e e y m c 
e w G c e r r e e e e e 
g e g R g e e e e e r B 
e R r c e e e e g e b e 
e e e e e h e g e e e w 
e b b e e e b e w e G e 
e e G e e R e e g e g B 
e e e e e e e e e e e e 
e c g m e e e b f g g r 
e g e e e e g e e e e c 
