12 12
0
f e g e e R e e c e e m 
B b g e c e e e m e e b 
e b r r e r m r w e e y 
R e m g e g e G e e r e 
m e e r g g e m g e e e 
c e r B e b e e e g e e 
e r e G e w b e e e e e 
e e r e e r e r B e e e 
e c g e e e r e B e y e 
r e g e B e R w e e s e 
e r r e b e c b b e b e 
e G e e e e v e g w r b 
