12 12
0
e e m e w e e R e r e e 
e b f w r g e e e m R y 
e c g e e w e e b e w c 
r m c w w w e c e e b e 
e c e e c b c e e y e e 
c e e g G B e e e e e e 
e r b e e e e b v c e b 
e B e e e e c m e G e G 
e e b r b g y m b e e r 
e e r g e R e e e r e e 
R g w B m e v G e g w e 
e m e e g s e e e c b g 
