12 12
0
b m e f e b e m e e y c 
w e r w w e R g G e B m 
e g r e b y g g m w y e 
e e w r r e e g s e e G 
e e R c c e e e w e e G 
r e R e c e b g e G e e 
e e e e g g B e y g b m 
e e e g e b e r e m G e 
e e G e g e r e y e e e 
e b e b e y r e e e r e 
R e e e e e e c w e r e 
r e r R e e e c e y e e 
