5 5
0
e B w e G 
R m e B w 
B r c r r 
c e b b y 
B e g e e 
