6 6
0
e R m e e e 
e e r e R e 
e c e y e e 
w B r c e e 
e G e g e b 
e e e e b e 
