5 5
0
e G R e e 
e m e e e 
b B w y y 
b g B e c 
e e e b e 
