5 5
0
e e c e e 
B b e w e 
c G w e R 
e m e y m 
b e e e e 
