6 6
0
e e g e e e 
G b e e e e 
B m e e w R 
y e g c e w 
e G e y g m 
e e y e e e 
