5 5
0
e e e c e 
e B b y e 
e e r b e 
e c e R r 
G w e b e 
