5 5
0
e e R G w 
e w e m e 
b G r e e 
e B e c c 
e e r m e 
