5 5
0
e e e B e 
R e w e y 
R g r y e 
e w e e w 
m G g e e 
