5 5
0
e e e e e 
e B e G e 
e e m e y 
c m e w m 
e e R b e 
