5 5
6
e e e R b
r m m m b
e e b b e
B e b e e
e e b e e