5 5
0
e e G b R 
B c e m e 
y R y e c 
e b w g e 
e e e y e 
