5 5
0
e e e e B 
e y G e g 
c G w c b 
G m e w e 
b e R w e 
