5 5
0
e e e B G 
r w e R w 
y e y b y 
e R r r e 
G e c b e 
