5 5
0
e e R e r 
e e c b e 
B c e G g 
e e y y e 
e w m e e 
