6 6
0
e e G r e B 
e e e w G w 
e e e e r r 
e e e e m e 
R e e r e w 
e e e e m e 