5 5
0
e e e G e
y e w w e
e b R B e
e e w e y
B R e y e