6 6
0
e e g e e B 
R e e g R e 
e e e b e e 
e e e w e e 
G e b b m m 
e e r e b e 
