5 5
0
e e e e G 
m r R e e 
B e c y w 
g b e b r 
e e e e e 
