5 5
0
e e w e e 
e G g e R 
e b B e e 
c e e r b 
e e w y e 
