5 5
0
e b e e G 
R r e e e 
b m r w B 
R G w e g 
e g R m e 
