5 5
0
e B r e e 
R c e e e 
y e m e e 
G c e e g 
e r e c e 
