5 5
0
e R g B e 
B b e g e 
r G y e G 
e y e g w 
c e r r e 
