5 5
0
e e e e R 
e e G e g 
e e y c B 
e b b e y 
m e e b e 
