5 5
0
e e b R B 
B e e r b 
e e e m w 
G e e y e 
e e g r e 
