5 5
0
e e e e e 
e B e c G 
e e m e y 
e y R g e 
e e b m e 
