5 5
0
e e b e e 
G g e b e 
r G e r e 
e e g b e 
B r e m e 
