5 5
0
e e e b e 
B e r B G 
g c e e w 
e e c b y 
e e e g e 
