5 5
0
e R e B e 
w b y r w 
e e e c e 
G e e g e 
e e y e e 
