5 5
0
e R w e e 
G c e e e 
e e y g e 
e m e B r 
w e e c e 
