5 5
0
e e r G e 
e e e m R 
m G e e g 
e y m y b 
e e r e e 
