5 5
0
e R e e B 
e G w g c 
e g r b y 
c w m e e 
R e e w e 
