5 5
0
e G m R e 
e w e e e 
g G r B e 
R y g w g 
e b e y e 
