5 5
0
e c e G r 
R w e m e 
B b e g e 
r e m e e 
e e r c e 
