5 5
0
e G R r e 
r c c G e 
y e e r g 
G R b c y 
e y e e e 
