5 5
0
e r e G e 
e e m e R 
e e R c b 
e B g m g 
e e w e e 
