5 5
0
e e e G R 
e B e w b 
e e g r m 
w y w e e 
e e e e e 
