5 5
0
e r e R e 
B b e e c 
r e m g e 
G m g e e 
B r e e e 
