5 5
0
e e R e b 
G e e y e 
g m w R e 
e c e y b 
c g B c e 
