5 5
0
e e G c e 
y B y e e 
R g b e e 
b e e y b 
e G e r e 
