5 5
0
e b e R y 
R G g b e 
w c g e B 
B r e e b 
y h e b e 