5 5
0
e e B e G 
e e e R e 
e e g b b 
e c e e r 
e e b c e 
