5 5
0
e G e e B 
y r e m e 
e e b g w 
B e r e e 
R m e r e 
